sp|P0A7H6|RECR_ECOLI	CLPGVGPKSAQRMAFTLLQRDRSGGMRLAQALTRAMSEIGHCADCRTFTEQEVC	
sp|P08394|RECB_ECOLI	CSLGVAPLVRRRGDKKGDTDVHQSALGRLLQKGEPQDAAGLRTCIEALCDDDIAWQTAQTGDNQPWQVNDVSTAELNAKTLQRLPGDNWRVTSYSGLQQRGHGIAQDLMPRLDVDAAGVASVVEEPTLTPHQFPRGASPGTFLHSLFEDLDFTQPVDPNWVREKLELGGFESQWEPVLTEWITAVLQAPLNETGVSLSQLSARNKQVEMEFYLPISEPLIASQLDTLIRQFDPLSAGC	
sp|P09029|PURK_ECOLI	CVLGNGQLGRMLRQAGEPLGIAVWPVGLDAEPAAVPFQQSVITAEIERWPETALTRELARHPAFVNRDVFPIIADRLTQKQLFDKLHLPTAPWQLLAERSEWPAVFDRLGELAIVKRRTGGYDGRGQWRLRANETEQLPAECYGECIVEQGINFSGEVSLVGARGFDGSTVFYPLTHNLHQDGILRTSVAFPQANAQQQAQAEEMLSAIMQELGYVGVMAMEC	
sp|P37906|PUUB_ECOLI	CGTQVITTERLSEDLARSLIPKNYCVEDCNYLLDYYRLTADNRLLYGGGVVYGARDPDDVERLVVPKLLKTFPQLKGVKIDYRWTGNFLLTLSRMPQFGRLDTNIYYMQGYSGHGVTC	
sp|P37624|RBBA_ECOLI	CPRIAWMPQGLGKNLYHTLSVYENVDFFARLFGHDKAEREVRINELLTSTGLAPFRDRPAGKLSGGMKQKLGLCCALIHDPELLILDEPTTGVDPLSRSQFWDLIDSIRQRQSNMSVLVATAYMEEAERFDWLVAMNAGEVLATGSAEELRQQTQSATLEEAFINLLPQAQRQAHQAVVIPPYQPENAEIAIEARDLTMRFGSFVAVDHVNFRIPRGEIFGFLGSNGC	 Cell inner membran
sp|P77379|RCLR_ECOLI	CVLGSDWQLPHGAGELSVIRWHALTQGAAKLEMPTGEIFTLRPGNVVLLPQNSAHRLSHVDNESTCIVCGTLRLQHSARYFLTSLPETLFLAPVNHSVEYNWLREAIPFLQQESRSAMPGVDALC	
sp|P24554|RADA_ECOLI	CGADYPRWQGQCSACHAWNTITEVRLAASPMVARNERLSGYAGSAGVAKVQKLSDISLEELPRFSTGFKEFDRVLGGGVVPGSAILIGGNPGAGKSTLLLQTLC	
sp|P16917|RHSB_ECOLI	CAEYDEWGNLLNEENPHQLQQLIRLPGQQYDEESGLYYNRHRYYDPLQGRYITQDPIGLKGGWNLYGYQLNPISDIDPLGLSMWEDAKSGACTNGLCGTLSAMIGPDKFDSIDSTAYDALNKINSQSIC	
sp|P19624|PDXA_ECOLI	CADATLLTNRAAMLGLPLTLRPYSPNSPAQPQTAGTLTLLPVALRAPVTAGQLAVENGHYVVETLARACDGCLNGEFAALITGPVHKGVINDAGIPFTGHTEFFEERSQAKKVVMMLATEELRVALATTHLPLRDIADAITPALLHEVIAILHHDLRTKFGIAEPRILVC	 Cytoplasm {ECO:0000255|HAMAP-Rule:MF_00536}
sp|P09373|PFLB_ECOLI	CRKSGVLTGLPDAYGRGRIIGDYRRVALYGIDYLMKDKLAQFTSLQADLENGVNLEQTIRLREEIAEQHRALGQMKEMAAKYGYDISGPATNAQEAIQWTYFGYLAAVKSQNGAAMSFGRTSTFLDVYIERDLKAGKITEQEAQEMVDHLVMKLRMVRFLRTPEYDELFSGDPIWATESIGGMGLDGRTLVTKNSFRFLNTLYTMGPSPEPNMTILWSEKLPLNFKKFAAKVSIDTSSLQYENDDLMRPDFNNDDYAIACCVSPMIVGKQMQFFGARANLAKTMLYAINGGVDEKLKMQVGPKSEPIKGDVLNYDEVMERMDHFMDWLAKQYITALNIIHYMHDKYSYEASLMALHDRDVIRTMAC	 Cytoplasm
sp|P36938|PGM_ECOLI	CYVGKDTHALSEPAFISVLEVLAANGVDVIVQENNGFTPTPAVSNAILVHNKKGGPLADGIVITPSHNPPEDGGIKYNPPNGGPADTNVTKVVEDRANALLADGLKGVKRISLDEAMASGHVKEQDLVQPFVEGLADIVDMAAIQKAGLTLGVDPLGGSGIEYWKRIGEYYNLNLTIVNDQVDQTFRFMHLDKDGAIRMDCSSECAMAGLLALRDKFDLAFANDPDYDRHGIVTPAGLMNPNHYLAVAINYLFQHRPQWGKDVAVGKTLVSSAMIDRVVNDLGRKLVEVPVGFKWFVDGLFDGSFGFGGEESAGASFLRFDGTPWSTDKDGIIMC	 Cytoplasm {ECO:0000269|PubMed:21778229}
sp|P23842|PDEA_ECOLI	CLLYMVRIYHRSEWLNRRWHLQALTDPLTLLPNFRALEQAPEQEAGKSFCCLRIDNLEFMSRHYGLMMRVHC	 Cell membrane {ECO:0000305}; Multi-pas
sp|P52647|NIFJ_ECOLI	CPAKDRQNPEIKAINMMSRLEHVEEEKINYDFFLNLPEIDRSKLERIDIRTSQLITPLFEYSGACSGCGETPYIKLLTQLYGDRMLIANATGC	
sp|P40710|NLPE_ECOLI	CNNRAEVDTLSPAQAAELKPMPQSWRGVLPCADCEGIETSLFLEKDGTWVMNERYLGAREEPSSFASYGTWARTADKLVLTDSKGEKSYYRAKGDALEMLDREGNPIESQFNYTLEAAQSSLPMTPMTLRGMYFYMADAATFTDC	 Cell outer membran
sp|P23538|PPSA_ECOLI	CLPNEGVGLARLEFIINRMIGVHPRALLEFDDQEPQLQNEIREMMKGFDSPREFYVGRLTEGIATLGAAFYPKRVIVRLSDFKSNEYANLVGGERYEPDEENPMLGFRGAGRYVSDSFRDCFALECEAVKRVRNDMGLTNVEIMIPFVRTVDQAKAVVEELARQGLKRGENGLKIIMMC	
sp|P76085|PAAK_ECOLI	CLETTDGPTIWEDHFYPEIVNPHDGTPLADGEHGELLFTTLTKEALPVIRYRTRDLTRLLPGTARTMRRMDRISGRSDDMLIIRGVNVFPSQLEEEIVKFEHLSPHYQLEVNRRGHLDSLSVKVELKESSLTLTHEQRCQVCHQLRHRIKSMVGISTDVMIVNC	
sp|P77455|PAAZ_ECOLI	CGSAGDLLDHLDSQDVVTFTGSAATGQMLRVQPNIVAKSIPFTMEADSLNCCVLGEDVTPDQPEFALFIREVVREMTTKAGQKC	
sp|P31462|MDTL_ECOLI	CSLAETSTLFLAGRFLQGLGAGCCYVVAFAILRDTLDDRRRAKVLSLLNGITC	 Cell inner membrane; Multi-pass membran
sp|P77397|MHPA_ECOLI	CDGGASFVRRTLNVPFEGKTAPNQWIVVDIANDPLSTPHIYLCCDPVRPYVSAALPHAVRRFEFMVMPGETEEQLREPQNMRKLLSKVLPNPDNVELIRQRVYTHNARLAQRFRIDRVLLAGDAAHIMPVWQGQGYNSGMRDAFNLAWKLALVIQGKARDALLDTYQQERRDHAKAMIDLSVTAGNVLAPPKRWQGTLRDGVSWLLNYLPPVKRYFLEMRFKPMPQYYGGALMREGEAKHSPVGKMFIQPKVTLENGDVTLLDNAIGANFAVIGWGC	
sp|P13009|METH_ECOLI	CYVTAHPNAGLPNAFGEYDLDADTMAKQIREWAQAGFLNIVGGCCGTTPQHIAAMSRAVEGLAPRKLPEIPVAC	
sp|P24200|MCRA_ECOLI	CGYQAYFSRTGRKEIPSGNRTKRILINVPGIYSDSFWASIIRGELSELSQPTDDESLLNMRVSKLIKKTLSQPEGSRKPVEVERLQKVYVRDPMVKAWILQQSKGICENCGKNAPFYLNDGNPYLEVHHVIPLSSGGADTTDNC	
sp|P23909|MUTS_ECOLI	CEQIGDPATSKGPVERKVVRIVTPGTISDEALLQERQDNLLAAIWQDSKGFGYATLDISSGRFRLSEPADRETMAAELQRTNPAELLYAEDFAEMSLIEGRRGLRRRPLWEFEIDTARQQLNLQFGTRDLVGFGVENAPRGLCAAGCLLQYAKDTQRTTLPHIRSITMEREQDSIIMDAATRRNLEITQNLAGGAENTLASVLDC	
sp|P30750|METN_ECOLI	CDEATSALDPATTRSILELLKDINRRLGLTILLITHEMDVVKRICDCVAVISNGELIEQDTVSEVFSHPKTPLAQKFIQSTLHLDIPEDYQERLQAEPFTDC	 Cell inner membrane {ECO:0000255|HAMAP
sp|P0A9F9|METR_ECOLI	CNEPQQTRLRIAIECHSCIQWLTPALENFHKNWPQVEMDFKSGVTFDPQPALQQGELDLVMTSDILPRSGLHYSPMFDYEVRLVLAPDHPLAAKTRITPEDLASETLLIYPVQRSRLDVWRHFLQPAGVSPSLKSVDNTLLLIQMVAARMGIAALPHWVVESFERQGLVVTKTLGEGLWSRLYAAVRDGEQRQPVTEAFIRSARNHAC	 Cytoplasm
sp|Q47689|MMUP_ECOLI	CASHFVFRRRHLQQGKALSELHYRAPWYPLVPVLGFVLCLVACVGLAFDPAQRIALWC	 Cell inner membrane {ECO:0000305}; Multi
sp|P37677|LYXK_ECOLI	CALSPQPGWAERDMAELWQCCMAVIRALLTHSGVSGEQIVGIGISAQGKGLFLLDKNDKPLGNAILSSDRRAMEIVRRWQEDGIPEKLYPLTRQTLWTGHPVSLLRWLKEHEPERYAQIGC	
sp|P0ACE0|MBHM_ECOLI	CEIENGVVSKAWASGTMWRGMEEIVKNRDPRDAWMIVQRICGVCTTTHALSSVRAAESALNIDVPVNAQYIRNIILAAHTTHDHIVHFYQLSALDWVDITSALQADPTKASEMLKGVSTWHLNSPEEFTKVQNKIKDLVASGQLGIFANGYWGHPAMKLPPEVNLIAVAHYLQALEC	 Cell membrane; Peripheral membrane protein
sp|P69739|MBHS_ECOLI	CISSGRPFIEKLKRAAAGASAIIAWGTCASWGCVQAARPNPTQATPIDKVITDKPIIKVPGC	 Cell inner membrane; Single-pass type 
sp|P54745|MNGA_ECOLI	CLNARFTSREEAIHALTQRLAALGKISSTEQFLEEVYRRESLGPTALGEGLAVPHGKTAAVKEAAFAVATLSEPLQWEGVDGPEAVDLVVLLAIPPNEAGTTHMQLLTALTTRLADDEIRARIQSATTPDELLSALDDKGGTQPSASFSNAPTIVCVTACPAGIAHTYMAAEYLEKAGRKLGVNVYVEKQGANGIEGRLTADQLNSATAC	 Cell inner membrane {ECO:0000255|PROSITE
sp|P37095|PEPB_ECOLI	CLVGKGITFDSGGYSIKQTAFMDSMKSDMGGAATVTGALAFAITRGLNKRVKLFLCCADNLISGNAFKLGDIITYRNGKKVEVMNTDAEGRLVLADGLIDASAQKPEMIIDAATLTGAAKTALGNDYHALFSFDDALAGRLLASAAQENEPFWRLPLAEFHRSQLPSNFAELNNTGSAAYPAGASTAAGFLSHFVENYQQGWLHIDC	 Cytoplasm {ECO:0000255|HAMAP-Rule:MF_00504}
sp|P32155|PTFLA_ECOLI	CVKQPFVLFARKAQAIDWKASDGEDVNCWICLGVPQSGEEDQVKIIGTLC	 Cytoplasm {ECO:0000305}
sp|P77439|PTFX1_ECOLI	CGVLAINPNDAVSGYYQVAQTLADKRQKQQAQAAAQLAYSRDNKRIDIAANIGTALEAPGAFANGAEGVGLFRTEMLYMDRDSAPDEQEQFEAYQQVLLAAGDKPIIFRTMDIGGDKSIPYLNIPQEENPFLGYRAVRIYPEFAGLFRTQLRAILRAASFGNAQLMIPMVHSLDQILWVKGEIQKAIVELKRDGLRHAETITLGIMVEVPSVCYIIDHFCDEVDFFSIGSNDMTQYLYAVDRNNPRVSPLYNPITPSFLRMLQQIVTTAHQRGKWVGIC	CRELARQACECRSAQEIEALLTAFTPEEDVRPLLALENIFVDQDFSNKEQAIQFLC	 Cytoplasm {ECO:0000305}
sp|P32670|PTFX2_ECOLI	CQALESANGRSIIVRTMDIGGDKPVDYLNIPAEANPFLGYRAVRIYEEYASLFTTQLRSILRASAHGSLKIMIPMISSMEEILWVKEKLAEAKQQLRNEHIPFDEKIQLGIMLEVPSVMFIIDQCCEEIDFFSIGSNDLTQYLLAVDRDNAKVTRHYNSLNPAFLRALDYAVQAVHRQGKWIGLC	 Cytoplasm {ECO:0000305}
sp|P00490|PHSM_ECOLI	CFLDSMATVGQSATGYGLNYQYGLFRQSFVDGKQVEAPDDWHRSNYPWFRHNEALDVQVGIGGKVTKDGRWEPEFTITGQAWDLPVVGYRNGVAQPLRLWQATHAHPFDLTKFNDGDFLRAEQQGINAEKLTKVLYPNDNHTAGKKLRLMQQYFQCACSVADILRRHHLAGRKLHELADYEVIQLNDTHPTIAIPELLRVLIDEHQMSWDDAWAITSKTFAYTNHTLMPEALERWDVKLVKGLLPRHMQIINEINTRFKTLVEKTWPGDEKVWAKLAVVHDKQVHMANLC	
sp|P0AC86|PHSG_ECOLI	CFLDSLATLGLPGRGYGIRYDYGMFKQNIVNGSQKESPDYWLEYGNPWEFKRHNTRYKVRFGGRIQQEGKKTRWIETEEILGVAYDQIIPGYDTDATNTLRLWSAQASSEINLGKFNQGDYFAAVEDKNHSENVSRVLYPDDSTYSGRELRLRQEYFLVSSTIQDILSRHYQLHKTYDNLADKIAIHLNDTHPVLSIPEMMRLLIDEHQFSWDDAFEVCCQVFSYTNHTLMSEALETWPVDMLGKILPRHLQIIFEINDYFLKTLQEQYPNDTDLLGRASIIDESNGRRVRMAWLAVVVSHKVNGVSELHSNLMVQSLFADFAKIFPGRFTNVTNGVTPRRWLAVANPSLSAVLDEHLGRNWRTDLSLLNELQQHC	
sp|P0A7A7|PLSB_ECOLI	CHRSHMDYLLLSYVLYHQGLVPPHIAAGINLNFWPAGPIFRRLGAFFIRRTFKGNKLYSTVFREYLGELFSRGYSVEYFVEGGRSRTGRLLDPKTGTLSMTIQAMLRGGTRPITLIPIYIGYEHVMEVGTYAKELRGATKEKESLPQMLRGLSKLRNLGQGYVNFGEPMPLMTYLNQHVPDWRESIDPIEAVRPAWLTPTVNNIAADLMVRINNAGAANAMNLCCTALLASRQRSLTREQLTEQLNC	 Cell inner membran
sp|P24211|RHSE_ECOLI	CDHRGLPLALISEDGNTAWRGEYDEWGNQLNEENPHHLHQPYRLPGQQHDEESGLYYNRHRHYDPLQGRYITPDPIGLRGGWNMYQYPLNPIQVIDPMGLDAIENMTSGGLIYAVSGVPGLIAANSITNSAYQFGYDMDAIVGGAHNGAADAMRHCYLMCRMTKTFGSTIADVIGKNHEAAGDRQGQPAKERIMDLKNNTVGIAC	
sp|P16919|RHSD_ECOLI	CDHRGLPLALISEDGNTAWSAEYDEWGNQLNEENPHHVYQPYRLPGQQHDEESGLYYNRHRYYDPLQGRYITQDPMGLKGGWNLYQYPLNPLQQIDPMGLLQTWDDARSGACTGGVCGVLSRIIGPSKFDSTADAALDALKETQNRSLC	
sp|P00452|RIR1_ECOLI	CLFSNYPRETRLQYVKRFYDAVSTFKISLPTPIMSGVRTPTRQFSSCVLIECGDSLDSINATSSAIVKYVSQRAGIGINAGRIRALGSPIRGGEAFHTGC	
sp|P21499|RNR_ECOLI	CSLNPQVDRLCMVCEMTVSSKGRLTGYKFYEAVMSSHARLTYTKVWHILQGDQDLREQYAPLVKHLEELHNLYKVLDKAREERGGISFESEEAKFIFNAERRIERIEQTQRNDAHKLIEEC	 Cytoplasm {ECO:0000305}
sp|P0A8T7|RPOC_ECOLI	CARIFGPVKDYECLCGKYKRLKHRGVIC	
sp|P31667|RPNA_ECOLI	CLIEHQSTSNKLIAFRMMRYAIAAMQNHLDAGYKTLPMVVPLLFYHGIESPYPYSLCWLDCFADPKLARQLYASAFPLIDVTVMPDDEIMQHRRMALLELIQKHIRQRDLMGLVEQMAC	
sp|P76104|RLHA_ECOLI	CDIRTVEKAKFLSDVGFTQIVLARELNLDQIRAIHQATDATIEFFIHGALCVAYSGQCYISHAQTGRSANRGDC	
sp|P0A8V2|RPOB_ECOLI	CRSKGESSLFSRDQVDYMDVSTQQVVSVGASLIPFLEHDDANRALMGANMQRQAVPTLRADKPLVGTGMERAVAVDSGVTAVAKRGGVVQYVDASRIVIKVNEDEMYPGEAGIDIYNLTKYTRSNQNTCINQMPCVSLGEPVERGDVLADGPSTDLGELALGQNMRVAFMPWNGYNFEDSILVSERVVQEDRFTTIHIQELAC	
sp|P27241|RFAZ_ECOLI	CKDISLGYCSCHTIAFAAIQIAYSLKYARIIC	
sp|P09378|RHAR_ECOLI	CPERLKLNLDWQGAIPGFNASAGQPHWRLGSMGMAQARQVIGQLEHESSQHVPFANEMAELLFGQLVMLLNRHRYTSDSLPPTSSETLLDKLITRLAASLKSPFALDKFCDEASCSERVLRQQFRQQTGMTINQYLRQVRVC	 Cytoplasm
sp|P0ADR6|RLMM_ECOLI	CRKFTVPLRAALRDAGVLANYETPKRPVVHVFFIAPGCCYTGYSYSNNNSPFYMGIPRLKFPADAPSRSTLKLEEAFHVFIPADEWDERLANGMWAVDLGAC	 Cytoplasm {ECO:0000305}
sp|P32171|RHAB_ECOLI	CRFIINPNDDRFINPETMCSEIQAACRETAQPIPESDAELARC	
sp|P27127|RFAB_ECOLI	CSFSNIRLGFLRRAKHIHALSKWLQEYQPDIVICIDVISCLFAAKARKKSGIDMPVFSWPHFSLDHKKHAEYITC	
sp|P25539|RIBD_ECOLI	CSHHGRTPPCCDALIAAGVARVVASMQDPNPQVAGRGLYRLQQAGIDVSHGLMMSEAEQLNKGFLKRMRTGFPYIQLKLGASLDGRTAMASGESQWITSPQARRDVQLLRAQSHAILTSSATVLADDPALTVRWSELDEQTQALYPQQNLRQPIRIVIDSQNRVTPVHRIVQQPGETWFARTQEDSREWPETVRTLLIPEHKGHLDLVVLMMQLGKQQINSIWVEAGPTLAGALLQAGLVDELIVYIAPKLLGSDARGLC	
sp|P0AG40|RIBF_ECOLI	CVLTIGNFDGVHRGHRALLQGLQEEGRKRNLPVMVMLFEPQPLELFATDKAPARLTRLREKLRYLAECGVDYVLCVRFDRRFAALTAQNFISDLLVKHLRVKFLAVGDDFRFGAGREGDFLLLQKAGMEYGFDITSTQTFC	
sp|P0A7I4|RF3_ECOLI	CLVNLLDTPGHEDFSEDTYRTLTAVDCCLMVIDAAKGVEDRTRKLMEVTRLRDTPILTFMNKLDRDIRDPMELLDEVENELKIGC	 Cytoplasm
sp|P0A7I7|RIBA_ECOLI	CLTGDALFSLRCDCGFQLEAALTQIAEEGRGILLYHRQEGRNIGLLNKIRAYALQDQGYDTVEANHQLGFAADERDFTLC	
sp|P32664|NUDC_ECOLI	CGHEMYPSKTEWAMLCSHCRERYYPQIAPC	
sp|P28305|PABC_ECOLI	CDFWPQLEQEMKTLAAEQQNGVLKVVISRGSGGRGYSTLNSGPATRILSVTAYPAHYDRLRNEGITLALSPVRLGRNPHLAGIKHLNRLEQVLIRSHLEQTNADEALVLDSEGWVTECCAANLFWRKGNVVYTPRLDQAGVNGIMRQFC	
sp|P33919|RADD_ECOLI	CLILDYAGNPHDLYAPEVGTPKGKSDNVPVQVFCPACGFANTFWGKTTADGTLIEHFGRRC	CDFRFRFKNCPQCNAENDIAARRC	
sp|P76161|REQ2_ECOLI	CLTITDVMAAQGMVQSKAPLGLALFLAKVGVQDPQFAIEGLLNYAMALDNPTLNKLSEEIRLQIIPYLVSFAFADYSRSAASKARCEHCSGTGFYNVLREVVKHYRRGESVIKEEWVKELC	
sp|P27129|RFAJ_ECOLI	CLNVAYGVDANYLDGVGVSITSIVLNNRHINLDFYIIADVYNDGFFQKIAKLAEQNQLRITLYRINTDKLQCLPCTQVWSRAMYFRLFAFQLLGLTLDRLLYLDADVVC	
sp|P75817|RLMC_ECOLI	CAPVSGPEQGFRNKAKMVVSGSVEKPLLGMLHRDGTPEDLCDCPLYPASFAPVFAALKPFIARAGLTPYNVARKRGELKYILLTESQSDGGMMLRFVLRSDTKLAQLRKALPWLHEQLPQLKVITVNIQPVHMAIMEGETEIYLTEQQALAERFNDVPLWIRPQSFFQTNPAVASQLYATARDWVRQLPVKHMWDLFC	
sp|P0AG20|RELA_ECOLI	CIGAKIGGRIVPFTYQLQMGDQIEIITQKQPNPSRDWLNPNLGYVTTSRGRSKIHAWFRKQDRDKNILAGRQILDDELEHLGISLKEAEKHLLPRYNFNDVDELLAAIGGGDIRLNQMVNFLQSQFNKPSAEEQDAAALKQLQQKSYTPQNRSKDNGRVVVEGVGNLMHHIARCCQPIPGDEIVGFITQGRGISVHRADC	
sp|Q46829|BGLA_ECOLI	CFRTSIAWTRIFPKGDEAQPNEEGLKFYDDMFDELLKYNIEPVITLSHFEMPLHLVQQYGSWTNRKVVDFFVRFAEVVFERYKHKVKYWMTFNEINNQRNWRAPLFGYCCSGVVYTEHENPEETMYQVLHHQFVASALAVKAARRINPEMKVGC	
sp|P75726|CILA_ECOLI	CDEFGNANGYTGKACCGSLGYAIVDADNAKQVVMLTEELLPYPHNPASIEQDQVDLIVKVDRVGDAAKIGAGATRMTTNPRELLIARSAADVIVNSGYFKEGFSMQTGTGGASLAVTRFLEDKMRSRDIRADFALGGITATMVDLHEKGLIRKLLDVQSFDSHAAQSLARNPNHIEISANQYANWGSKGASVDRLDVVVLSALEIDTQFNVNVLTGSDGVLRGASGGHC	 Cytoplasm
sp|P37653|BCSA_ECOLI	CDHVPTRSFLQMTMGWFLKEKQLAMMQTPHHFFSPDPFERNLGRFRKTPNEGTLFYGLVQDGNDMWDATFFCGSCAVIRRKPLDEIGGIAVETVTEDAHTSLRLHRRGYTSAYMRIPQAAGLATESLSAHIGQRIRWARGMVQIFRLDNPLTGKGLKFAQRLC	 Cell inner membrane {ECO:0000305}; Multi
sp|P77231|CITG_ECOLI	CAAIGRLLQLNQPVTPTTVCSTAASFCRGLTDRELRTNNSQLTAGQRLYQQLGLTGARGEAEAGYPLVINHALPHYLTLLDQGLDPELALLDTLLLLMAINGDTNVASRGGEGGLRWLQREAQTLLQKGGIRTPADLDYLRQFDREC	
sp|P75980|BEEE_ECOLI	CNLYHLNGSLKQRATGERLHKLISTHPNGYMTPQEFWELVVTCLCLRGNFYAYKVKAFGEVAELLPVDPGC	
sp|P06864|BGA2_ECOLI	CVRVMQWADSTYVEDQDMWWSAGIFRDVYLVGKHLTHINDFTVRTDFDEAYCDATLSCEVVLENLAASPVVTTLEYTLFDGERVVHSSAIDHLAIEKLTSASFAFTVEQPQQWSAESPYLYHLVMTLKDANGNVLEVVPQRVGFRDIKVRDGLFWINNRYVMLHGVNRHDNDHRKGRAVGMDRVEKDLQLMKQHNINSVRTAHYPNDPRFYELC	
sp|P39334|BDCR_ECOLI	CLVEVLKEAARRYSQNGGCAGCMVLEGIHSHDPQARDIAVQYYHAAETTIYDYIARRHPQRAQC	
sp|P0ABB8|ATMA_ECOLI	CYRNPFNILLTILGAISYATEDLFAAGVIALMVAISTLLNFIQEARSTKAADALKAMVSNTATVLRVINDKGENGWLEIPIDQLVPGDIIKLAAGDMIPADLRILQARDLFVAQASLTGESLPVEKAATTRQPEHSNPLECDTLCFMGTTVVSGTAQAMVIATGANTWFGQLAGRVSEQESEPNAFQQGISRVSMLLIRFMLVMAPVVLLINGYTKGDWWEAALFALSVAVGLTPEMLPMIVTSTLARGAVKLSKQKVIVKHLDAIQNFGAMDILC	 Cell inner membran
sp|P25516|ACNA_ECOLI	CTNTSNPSVLMAAGLLAKKAVTLGLKRQPWVKASLAPGSKVVSDYLAKAKLTPYLDELGFNLVGYGCTTCIGNSGPLPDPIETAIKKSDLTVGAVLSGNRNFEGRIHPLVKTNWLASPPLVVAYALAGNMNINLASEPIGHDRKGDPVYLKDIWPSAQEIARAVEQVSTEMFRKEYAEVFEGTAEWKGINVTRSDTYGWQEDSTYIRLSPFFDEMQATPAPVEDIHGARILAMLGDSVTTDHISPAGSIKPDSPAGRYLQGRGVERKDFNSYGSRRGNHEVMMRGTFANIRIRNEMVPGVEGGMTRHLPDSDVVSIYDAAMRYKQEQTPLAVIAGKEYGSGSSRDWAAKGPRLLGIRVVIAESFERIHRSNLIGMGILPLEFPQGVTRKTLGLTGEEKIDIGDLQNLQPGATVPVTLTRADGSQEVVPC	
sp|P31440|ADEQ_ECOLI	CLIAGIGSIAMGIFANLPVALAPAMGLNAFFAFVVVGAMGISWQTGMGAIFWGAVGLFLLTLFRIRYWMISNIPLSLRIGITSGIGLFIALMGLKNTGVIVANKDTLVMIGDLSSHGVLLGILGFFIITVLSSRHFHAAVLVSIVVTSCCGLFFGDVHFSGVYSIPPDISGVIGEVDLSGALTLELAGIIFSFMLINLFDSSGTLIGVTDKAGLIDGNGKFPNMNKALYVDSVSSVAGAFIGTSSVTAYIESTSGVAVGGRTGLTAVVVGVMFLLVMFFSPLVAIVPPYATAGALIFVGVLMTSSLARVNWDDFTESVPAFITTVMMPFTFSITEGIALGFMSYC	 Cell inner membran
sp|P60061|ADIC_ECOLI	CYVLSTTAIMGMIPNAALRVSASPFGDAARMALGDTAGAIVSFCAAAGCLGSLGGWTLLAGQTAKAAADDGLFPPIFARVNKAGTPVAGLIIVGILMTIFQLSSISPNATKEFGLVSSVSVIFTLVPYLYTC	 Cell inner membrane; Multi-pass membran
sp|P06720|AGAL_ECOLI	CKRHGLEQTIADTLGPGGIMRALRTIPHLWQICEDMTEVCPDATMLNYVNPMAMNTWAMYARYPHIKQVGLC	
sp|P00561|AK1H_ECOLI	CLIKNTGNPQAPGTLIGASRDEDELPVKGISNLNNMAMFSVSGPGMKGMVGMAARVFAAMSRARISVVLITQSSSEYSISFCVPQSDCVRAERAMQEEFYLELKEGLLEPLAVTERLAIISVVGDGMRTLRGISAKFFAALARANINIVAIAQGSSERSISVVVNNDDATTGVRVTHQMLFNTDQVIEVFVIGVGGVGGALLEQLKRQQSWLKNKHIDLRVC	
sp|P76052|ABGB_ECOLI	CSSYLPNRTLENAMYQALSHFGTPEWNSEELAFAKQIQATLTSNDRQNSLNNIAATGGENGKVFALRHRETVLANEVAPYAATDNVLAASTDVGDVSWKLPVAQCFSPCFAVGTPLHTWQLVSQGRTSIAHKGMLLAAKTMAATTVNLFLDSGLLQEC	
sp|P35340|AHPF_ECOLI	CPDVVQALNLMSVLNPRIKHTAIDGGTFQNEITDRNVMGVPAVFVNGKEFGQGRMTLTEIVAKIDTGAEKRAAEELNKRDAYDVLIVGSGPAGAAAAIYSARKGIRTGLMGERFGGQILDTVDIENYISVPKTEGQKLAGALKVHVDEYDVDVIDSQSASKLIPAAVEGGLHQIETASGAVLKARSIIVATGAKWRNMNVPGEDQYRTKGVTYCPHCDGPLFKGKRVAVIGGGNSGVEAAIDLAGIVEHVTLLEFAPEMKADQVLQDKLRSLKNVDIILNAQTTEVKGDGSKVVGLEYRDRVSGDIHNIELAGIFVQIGLLPNTNWLEGAVERNRMGEIIIDAKC	
sp|P0A991|ALF1_ECOLI	CMTIPSDQLYLPGHDYVDRVMIDNNRPPAVLRNMQTLYNTGRLAGTGYLSILPVDQGVEHSAGASFAANPLYFDPKNIVELAIEAGCNCVASTYGVLASVSRRYAHRIPFLVKLNHNETLSYPNTYDQTLYASVEQAFNMGAVAVGATIYFGSEESRRQIEEISAAFERAHELGMVTVLWAYLRNSAFKKDGVDYHVSADLTGQANHLAATIGADIVKQKMAENNGGYKAINYGYTDDRVYSKLTSENPIDLVRYQLANC	 Cytoplasm {ECO:0000305}
sp|P37127|AEGA_ECOLI	CPFGTMQIVLTPVAAGKVKATAHKCDLCAGRENGPAC	
sp|P33234|ADIY_ECOLI	CVSDSVYQIIESDIHKDWNLSMVASCLCLSPSLLKKKLKSENTSYSQIITTC	
sp|P38036|CAS3_ECOLI	CYEGVHALLDNGYQPRQLQVLVDALPVAPGLTVIEAPTGSGKTETALAYAWKLIDQQIADSVIFALPTQATANAMLTRMEASASHLFSSPNLILAHGNSRFNHLFQSIKSRAITEQGQEEAWVQCCQWLSQSNKKVFLGQIGVC	
sp|P23910|ARAJ_ECOLI	CGGMKTTSLIFAFICCAGLFALSAPLQILLLQNAKGGELLGAAGGQIAFNLGSAVGAYC	 Cell inner membran
sp|P30845|EPTA_ECOLI	CDRVPHQNVTALNLPDQCINGECYDEVLFHGLEEYINNLQGDGVIVLHTIGSHGPTYYNRYPPQFRKFTPTC	 Cell inner membran
sp|P0ABS5|DNAG_ECOLI	CPFHNEKTPSFTVNGEKQFYHCFGCGAHGNAIDFLMNYDKLEFVETVEELAAMHNLEVPFEAGSGPSQIERHQRQTLYQLMDGLNTFYQQSLQQPVATSARQYLEKRGLSHEVIARFAIGFAPPGWDNVLKRFGGNPENRQSLIDAGMLVTNDQGRSYDRFRERVMFPIRDKRGRVIGFGGRVLGNDTPKYLNSPETDIFHKGRQLYGLYEAQQDNAEPNRLLVVEGYMDVVALAQYGINYAVASLGTSTTADHIQLLFRATNNVIC	
sp|P75974|COHE_ECOLI	CFDLPVGWLDQEHQTTNITKKPDVSITNKQITLVPVISWVQAGAWKEVGYSEVDLSTAETYPCPVPCGEMTYILRVIGDSMIDEYRPGDMIFVDPEVPAC	
sp|P69910|DCEB_ECOLI	CMLGGMAMKWRWRKRMEAAGKPTDKPNLVCGPVQICWHKFARYWDVELREIPMRPGQLFMDPKRMIEAC	 Cytoplasm {ECO:0000269|PubMed:12912902}
sp|P15042|DNLJ_ECOLI	CESAEEVLAFYHKVEEDRPTLGFDIDGVVIKVNSLAQQEQLGFVARAPRWAVAFKFPAQEQMTFVRDVEFQVGRTGAITPVARLEPVHVAGVLVSNATLHNADEIERLGLRIGDKVVIRRAGDVIPQVVNVVLSERPEDTREVVFPTHCPVCGSDVERVEGEAVARC	
sp|P18775|DMSA_ECOLI	CLRGRSMRRRVYNPDRLKYPMKRVGARGEGKFERISWEEAYDIIATNMQRLIKEYGNESIYLNYGTGTLGGTMTRSWPPGNTLVARLMNCCGGYLNHYGDYSSAQIAEGLNYTYGGWADGNSPSDIENSKLVVLFGNNPGETRMSGGGVTYYLEQARQKSNARMIIIDPRYTDTGAGREDEWIPIRPGTDAALVNGLAYVMITENLVDQAFLDKYC	 Cell membrane {ECO:0000269|PubMed:2170332
sp|P21189|DPO2_ECOLI	CRAHRQLMNYEKRLREGGVTVYEADVRPPERYLMERFITSPVWVEGDMHNGTIVNARLKPHPDYRPPLKWVSIDIETTRHGELYCIGLEGCGQRIVYMLGPENGDASSLDFELEYVASRPQLLEKLNAWFANYDPDVIIGWNVVQFDLRMLQKHAERYRLPLRLGRDNSELEWREHGFKNGVFFAQAKGRLIIDGIEALKSAFWNFSSFSLETVAQELLGEGKSIDNPWDRMDEIDRRFAEDKPALATYNLKDC	
sp|P0A8N7|EPMA_ECOLI	CMSQATVTDIHLVPFETRFVGPGHSQGMNLWLMTSPEYHMKRLLVAGCGPVFQLCRSFRNEEMGRYHNPEFTMLEWYRPHYDMYRLMNEVDDLLQQVLDC	
sp|P0A9P0|DLDH_ECOLI	CADLGLETVIVERYNTLGGVCLNVGCIPSKALLHVAKVIEEAKALAEHGIVFGEPKTDIDKIRTWKEKVINQLTGGLAGMAKGRKVKVVNGLGKFTGANTLEVEGENGKTVINFDNAIIAAGSRPIQLPFIPHEDPRIWDSTDALELKEVPERLLVMGGGIIGLEMGTVYHALGSQIDVVEMFDQVIPAADKDIVKVFTKRISKKFNLMLETKVTAVEAKEDGIYVTMEGKKAPAEPQRYDAVLVAIGRVPNGKNLDAGKAGVEVDDRGFIRVDKQLRTNVPHIFAIGDIVGQPMLAHKGVHEGHVAAEVIAGKKHYFDPKVIPSIAYTEPEVAWVGLTEKEAKEKGISYETATFPWAASGRAIASDC	 Cytoplasm {ECO:0000269|PubMed:16079137}
sp|P37661|EPTB_ECOLI	CMFVRQGGAEDNPQRTLKEQNIFAVLKQLGFSSDLYAMQSEMWFYSNTMADNIAYREQIGAEPRNRGKPVDDMLLVDEMQQSLGRNPDGKHLIILHTKGSHFNYTQRYPRSFAQWKPECIGVDSGCTKAQMINSYDNSVTYVDHFISSVIDQVRDKKAIVFYAADHGESINEREHLHGTPRELAPPEQFRVPMMVWMSDKYLENPANAQAFAQLKKEADMKVPRRHVELYDTIMGC	 Cell inner membran
sp|P08622|DNAJ_ECOLI	CHGSGAKPGTQPQTCPTCHGSGQVQMRQGFFAVQQTC	 Cytoplasm
sp|P54901|CSIE_ECOLI	CSRRLQKRFESRDIHFLCLYLQYCLLQHHAGITPQFNPLQRRWAESC	
sp|P33371|DUSC_ECOLI	CPELQNASRTPSGTLVRVQLLGQFPQWLAENAARAVELGSWGVDLNCGCPSKTVNGSGGGATLLKDPELIYQGAKAMREAVPAHLPVSVKVRLGWDSGEKKFEIADAVQQAGATELVVHGRTKEQGYRAEHIDWQAIGDIRQRLNIPVIANGEIWDWQSAQQC	
sp|P36655|DSBD_ECOLI	CSTSVFAGLFDAPGRSQFVPADQAFAFDFQQNQHDLNLTWQIKDGYYLYRKQIRITPEHAKIADVQLPQGVWHEDEFYGKSEIYRDRLTLPVTINQASAGATLTVTYQGCADAGFCYPPETKTVPLSEVVANNAAPQPVSVPQQEQPTAQLPFSALWALLIGIGIAFTPC	 Cell inner membrane; Multi-pass membran
sp|P0AB91|AROG_ECOLI	CHIILRGGKEPNYSAKHVAEVKEGLNKAGLPAQVMIDFSHANSSKQFKKQMDVCADVCQQIAGGEKAIIGVMVESHLVEGNQSLESGEPLAYGKSITDAC	
sp|P00887|AROH_ECOLI	CQKQHRRQLEVCEDICQQIRNGSTAIAGIMAESFLREGTQKIVGSQPLTYGQSITDPC	
sp|P25550|ASLB_ECOLI	CDAGVEFIQFIPVVERLADETTARDGLKLHAPGDIQGELTEWSVRPEEFGEFLVAIFDHWIKRDVGKIFVMNIEWAFANFVGAPGAVCHHQPTCGRSVIVEHNGDVYAC	
sp|P08204|ARAB_ECOLI	CFTDQGIAVNNVMALGGIARKNQVIMQACCDVLNRPLQIVASDQC	
sp|P0AAE5|ARCD_ECOLI	CGAYLSWTIMAAEVPFLAATHKAFPRIFARQNAQAAPSASLWLTNICVQICLVLIWLTGSDYNTLLTIASEMILVPYFLVGAFLLKIATRPLHKAVGVGAC	 Cell inner membrane; Multi-pass membran
sp|P23325|ARPA_ECOLI	CKNQTLALVSSRPEGRCVAACGDFGLVMKAYFDKMESNGISVMAAILLVDNHALTVRLRIKNTTEGC	
sp|P00968|CARB_ECOLI	CARGLDLSPTKELLIDESLIGWKEYEMEVVRDKNDNCIIVCSIENFDAMGIHTGDSITVAPAQTLTDKEYQIMRNASMAVLREIGVETGGSNVQFAVNPKNGRLIVIEMNPRVSRSSALASKATGFPIAKVAAKLAVGYTLDELMNDITGGRTPASFEPSIDYVVTKIPRFNFEKFAGANDRLTTQMKSVGEVMAIGRTQQESLQKALRGLEVGATGFDPKVSLDDPEALTKIRRELKDAGADRIWYIADAFRAGLSVDGVFNLTNIDRWFLVQIEELVRLEEKVAEVGITGLNADFLRQLKRKGFADARLAKLAGVREAEIRKLRDQYDLHPVYKRVDTC	CEANPSTDREKIMVLGGGPNRIGQGIEFDYCCVHASLALREDGYETIMVNC	
sp|P77671|ALLB_ECOLI	CGDRGIDNDFRDVNDWQFFKGAQKLGELGQPVLVHCENALICDELGEEAKREGRVTAHDYVASRPVFTEVEAIRRVLYLAKVAGC	CHVSSPEGVEEVTRARQEGQDVTCESCPHYFVLDTDQFEEIGTLAKC	
sp|Q46896|CAS1_ECOLI	CIMLEPGTRVSHAAVRLAAQVGTLLVWVGEAGVRVYASGQPGGARSDKLLYQAKLALDEDLRLKVVRKMFELRFGEPAPARRSVEQLRGIEGSRVRATYALLAKQYGVTWNGRRYDPKDWEKGDTINQCISAATSCLYGVTEAAILAAGYAPAIGFVHTGKPLSFVYDIADIIKFDTVVPKAFEIARRNPGEPDREVRLAC	 Cytoplasm {ECO:0000269|PubMed:21219465}
sp|Q6BF16|DGOA_ECOLI	CQLIVTPNIHSEVIRRAVGYGMTVCPGCATATEAFTALEAGAQALKIFPSSAFGPQYIKALKAVLPSDIAVFAVGGVTPENLAQWIDAGC	
sp|P66817|DIAA_ECOLI	CFTESIQTQIAAAEALPDAISRAAMTLVQSLLNGNKILCCGNGTSAANAQHFAASMINRFETERPSLPAIALNTDNVVLTAIANDRLHDEVYAKQVRALGHAGDVLLAISTRGNSRDIVKAVEAAVTRDMTIVALTGYDGGELAGLLGPQDVEIRIPSHRSARIQEMHMLTVNC	
sp|P17846|CYSI_ECOLI	CTSNPYESQLHAEAYEWAKKISEHLLPRTRAYAEIWLDQEKVATTDEEPILGQTYLPRKFKTTVVIPPQNDIDLHANDMNFVAIAENGKLVGFNLLVGGGLSIEHGNKKTYARTASEFGYLPLEHTLAVAEAVVTTQRDWGNRTDRKNAKTKYTLERVGVETFKAEVERRAGIKFEPIRPYEFTGRGDRIGWVKGIDDNWHLTLFIENGRILDYPARPLKTGLLEIAKIHKGDFRITANQNLIIAGVPESEKAKIEKIAKESGLMNAVTPQRENSMACVSFPTCPLAMAEAERFLPSFIDNIDNLMAKHGVSDEHIVMRVTGC	
sp|P0ABN5|DCUA_ECOLI	CKVDTDNILNSSTFKAGMSACICILGVAWLGDTFVSNNIDWIKDTAGEVIQGHPWLLAVIFFFASALLYSQAATAKALMPMALALNVSPLTAVASFAAVSGLFILPTYPTLVAAVQMDDTGTTRIGKFVFNHPFFIPGTLGVALAVC	 Cell inner membrane; Multi-pass membran
sp|P69908|DCEA_ECOLI	CMLGGMAMKWRWRKRMEAAGKPTDKPNLVCGPVQICWHKFARYWDVELREIPMRPGQLFMDPKRMIEAC	
sp|P0A830|DCTA_ECOLI	CTVVTGIAGMESMKAVGRTGAVALLYFEIVSTIALIIGLIIVNVVQPGAGMNVDPATLDAKAVAVYADQAKDQGIVAFIMDVIPASVIGAFASGNILQVLLFAVLFGFALHRLGSKGQLIFNVIESFSQVIFGIINMIMRLAPIGAFGAMAFTIGKYGVGTLVQLGQLIICFYITCILFVVLVLGSIAKATGFSIFKFIRYIREELLIVLGTSSSESALPRMLDKMEKLGC	 Cell inner membran
sp|P0ABN9|DCUB_ECOLI	CLFYGARKGGIALGLLGGIGLVILVFVFHLQPGKPPVDVMLVIIAVVAASATLQASGGLDVMLQIAEKLLRRNPKYVSIVAPFVTCTLTILCGTGHVVYTILPIIYDVAIKNNIRPERPMAASSIGAQMGIIASPVSVAVVSLVAMLGNVTFDGRHLEFLDLLAITIPSTLIGILAIGIFSWFRGKDLDKDEEFQKFISVPENREYVYGDTATLLDKKLPKSNWLAMWIFLGAIAVVALLGADSDLRPSFGGKPLSMVLVIQMFMLLTGALIIILTKTNPASISKNEVFRSGMIAIVAVYGIAWMAETMFGAHMSEIQGVLGEMVKEYPWAYAIVLLLVSKFVNSQAAALAAIVPVALAIGVDPAYIVASAPAC	 Cell inner membrane; Multi-pass membran
sp|P77359|DJLC_ECOLI	CFDFLSLLEYPIALQNQTVEYYFALERCCRYHPDYVTAFLAMEGPWLIPDDAKLHRKLLRWYSSVQTGMAELIPVAQQWQTEEPESEDARYYLC	
sp|P00393|DHNA_ECOLI	CIFLDNPHQARRFHQEMLNLFLKYSANLGANGKVNIAIVGGGATGVELSAELHNAVKQLHSYGYKGLTNEALNVTLVEAGERILPALPPRISAAAHNELTKLGVRVLTQTMVTSADEGGLHTKDGEYIEADLMVWAAGIKAPDFLKDIGGLETNRINQLVVEPTLQTTRDPDIYAIGDCASCPRPEGGFVPPRAQAAHQMATC	 Cell membrane
sp|P18776|DMSB_ECOLI	CPYGAPQYNETKGHMTKCDGCYDRVAEGKKPIC	
sp|P46068|DSDC_ECOLI	CSPEYAQRHALTNTVINLCHCTLLHDRQAWSNDSGTDEWHSWAQHYAVNLPTSSGIGFDRSDLAVIAAMNHIGVAMGRKRLVQKRLASGELVAPFGDMTVKC	
sp|P0AAJ3|FDNH_ECOLI	CPFNIPRLNKEDNRVYKCTLCVDRVSVGQEPAC	 Cell inner membran
sp|P32177|FDHD_ECOLI	CNGLEVQIELSSRRFMGLKERRRALAGRTGCGVCGVEQLNDIGKPVQPLPFTQTFDLNKLDDALRHLNDFQPVGQLTGC	 Cytoplasm {ECO:0000255|HAMAP-Rule:MF_00187
sp|P13024|FDHE_ECOLI	CGSMPVSSMVQIGTTQGLRYLHCNLCETEWHVVRVKC	 Cytoplasm
sp|P0A6C1|END4_ECOLI	CLARIAESINIALDKTQGVTAVIENTAGQGSNLGFKFEHLAAIIDGVEDKSRVGVCIDTCHAFAAGYDLRTPAEC	
sp|P38135|FADK_ECOLI	CLALLEQQRCTCMLGATPFVYDLLNVLEKQPADLSALRFFLC	 Cell membrane; Peripheral membrane protein
sp|Q47013|ELAD_ECOLI	CVIFNSLRALGYDKENSLKRVINSFNSELMGEMSNNNIKVHLNEPEIIFLHADLQQYLSQSCGAFVCMAAQEVIEQRESNSDSAPYTLLKNHADRFKKYSAEEQYEIDFQHRLANRNC	
sp|P0AEJ0|EMRB_ECOLI	CFLIVWELTDDNPIVDLSLFKSRNFTIGCLCISLAYMLYFGAIVLLPQLLQEVYGYTATWAGLASAPVGIIPVILSPIIGRFAHKLDMRRLVTFSFIMYAVC	 Cell inner membran
sp|P75672|YAFS_ECOLI	CWGDLPWGKLYRKALERQLNPWFTKMYGFHLLKIGNLSAEINCEACAVSHQVNVSAQGMPVQVQADPLHLPFADKSVDVC	
sp|P77657|YAGK_ECOLI	CYLTNRYPRLIAVRVDLHYPKIVDNGDNICCFPNLEPGVISRMRESLRAKLEADRTRKVREDKRIYRC	
sp|P77187|YAHF_ECOLI	CFLDRGETPVDEQGLQFARGTKEAALKAVMLSGVKQENLDLHTLNQPLIADVRARLQPQQKYIRGLFCGGTLCDETMFAVMEKHGDVYSNIQPDPEFRLKDINRSIKHTFLDFGDDDFTNGKPHPMIDPTNRISRLIEEARDPEVAVIVMDFVLGFGSHEDPVGSTIETIKEAKAIAAAEGRELIILAYVLGTDLDTPSLEQQSQMLLDAGVILASSSTNTGLLAREFIC	
sp|P77221|YAHG_ECOLI	CGAMKGAVTGALVFEGLAKDLDEAAELAASGEITFSPCHEHDCVGSMAGVTSASMFMHIVKNKTYGNIAYTNMSEQMAKILRMGANDQSVIDRLNWMRDVQGPILRDAMKIIGEIDLRLMLAQALHMGDEC	 Cell membrane {ECO:0000305}; Multi-pas
sp|P39160|UXUB_ECOLI	CTMVDRIVPAATPETLQEIADQLGVYDPCAIACEPFRQWVIEDNFVNGRPDWDKVGAQFVADVVPFEMMKLRMLNGSHSFLAYLGYLGGYETIADTVTNPAYRKAAFALMMQEQAPTLSMPEGTDLNAYATLLIERFSNPSLRHRTWQIAMDGSQKLPQRLLDPVRLHLQNGGSWRHLALGVAGWMRYTQGVDEQGNAIDVVDPMLAEFQKINAQYQGADRVKALLGLSGIFADDLPQNADFVGAVTAAYQQLC	
sp|P77427|YBEU_ECOLI	CKPAHDSPKMYTGIKEFELSSSWGINNRDDLIQTIYQMTDDGHANDLAGLYLTWHRSSPEEWKALIAGGSERGLIYTQFVAQTAMCCGEGGIKAWDYVRMGFLSRVGVLNKWLTEEESLWLQSRVYVRAHHYYHSWMHYFSAYSLGRLYWQSSQC	
sp|P75764|YBHJ_ECOLI	CGNDTFSLAVYPSSQPVFMDLAKKGVVADLIGAGAIIRTAFCGPCFGAGDTPINNGLSIRHTTRNFPNREGSKPANGQMSAVALMDARSIAATAANGGYLTSASELDC	
sp|P39300|ULAG_ECOLI	CTGIWLKSEGGTNVCVDFWCGTGKQSHGNPLMKQGHQMQRMAGVKKLQPNLRTTPFVLDPFAIRQIDAVLATHDHNDHIDVNVAAAVMQNC	 Cytoplasm {ECO:0000305}
sp|P04152|UMUC_ECOLI	CVIARNAEAKALGVKMGDPWFKQKDLFRRCGVVCFSSNYELYADMSNRVMSTLEELSPRVEIYSIDEAFC	
sp|P0AGM7|URAA_ECOLI	CKGKIPAYLGSSFAFISPVLLLLPLGYEVALGGFIMCGVLFCLVSFIVKKAGTGWLDVLFPPAAMGAIVAVIGLELAGVAAGMAGLLPAEGQTPDSKTIIISITTLAVTVLGSVLFRGFLAIIPILIGVLVGYALSFAMGIVDTTPIINAHWFALPTLYTPRFEWFAILTILPAALVVIAEHVGHLVVTANIVKKDLLRDPGLHRSMFANGLSTVISGFFGSTPNTTYGENIGVMAITRVYSTWVIGGAAIFAILLSC	 Cell inner membran
sp|P37049|YAEI_ECOLI	CEPGWFELIRHRLAFFKDNAAPFKILFLADLHYSRFVPLSLISDAIALGIEQKPDLILLGGDYVLFDMSLNFSAFSDVLSPLAECAPTFACFGNHDRPVGTEKNHLIGETLKSAGITVLFNQATVIATPNRQFELVGTGDLWAGQC	
sp|P37007|YAGA_ECOLI	CHPLTLLDDHSRFSLCLAHCTDERRETVQQQLVSVFERYGLPDRMTMDNGSPWGDTTGTWTALELWLMRLGIRVGHSRPYHPQTQGKLERFHRSLKAEVLQGKWFADSGELQRAFDHWRTVYNLERPHEALDMAVPGSRYQPSARQYSGNTTPPEYDEGVMVRKVDISGKLSVKGVSLSAGKAFRGERVGLKEMQEDGSYEVWWYSTKVGVIDLKKKSITMGKGC	
sp|P0A8G0|UVRC_ECOLI	CLQYQIGRCLGPCVEGLVSEEEYAQQVEYVRLFLSGKDDQVLTQLISRMETASQNLEFEEAARIRDQIQAVRRVTEKQFVSNTGDDLDVIGVAFDAGMAC	 Cytoplasm
sp|P0A698|UVRA_ECOLI	CDLSDPPKLELQKKHTIEVVVDRFKVRDDLTQRLAESFETALELSGGTAVVADMDDPKAEELLFSANFACPICGYSMRELEPRLFSFNNPAGAC	CDGLGVQQYFDPDRVIQNPELSLAGGAIRGWDRRNFYYFQMLKSLADHYKFDVEAPWGSLSANVHKVVLYGSGKENIEFKYMNDRGDTSIRRHPFEGVLHNMERRYKETESSAVREELAKFISNRPCASCEGTRLRREARHVYVENTPLPAISDMSIGHAMEFFNNLKLAGQRAKIAEKILKEIGDRLKFLVNVGLNYLTLSRSAETLSGGEAQRIRLASQIGAGLVGVMYVLDEPSIGLHQRDNERLLGTLIHLRDLGNTVIVVEHDEDAIRAADHVIDIGPGAGVHGGEVVAEGPLEAIMAVPESLTGQYMSGKRKIEVPKKRVPANPEKVLKLTGARGNNLKDVTLTLPVGLFTC	CQGDGVIKVEMHFLPDIYVPCDQCKGKRYNRETLEIKYKGKTIHEVLDMTIEEAREFFDAVPALARKLQTLMDVGLTYIRLGQSATTLSGGEAQRVKLARELSKRGTGQTLYILDEPTTGLHFADIQQLLDVLHKLRDQGNTIVVIEHNLDVIKTADWIVDLGPEGGSGGGEILVSGTPETVAEC	 Cytoplasm {ECO:0000255|HAMAP-Rule:MF_00205}
sp|Q47536|YAIP_ECOLI	CGMFRTDVLRKFGFSDRTKVEDLDLTWTLVANGYRIRQANRCIVYPQECNSPREEWRRWRRWIVGYAVC	
sp|P0CE44|UIDB_ECOLI	CFKSTRENVVRIVAQPSLNISLQTLKRNRPLFMLCIGALCVLISTFAVSASSLFYVRYVLNDTGLFTVLVLVQNLVGTVASAPLVPGMVARIGKKNTFLIGALLGTC	 Cell inner membrane; Multi-pass membran
sp|P52005|TORY_ECOLI	CHSMSKPFEEYQGTVHFSNQKGIRAECADCHIPKSGMDYLFAKLKASKDIYHEFVSGKIDSDDKFEAHRQEMAETVWKELKATDSATC	CHSFDAMDIASQSESAQKMHNKAQKDSETCIDCHKGIAHFPPEIKMDDNAAHELESQAATSVTNGAHIYPFKTSHIGELATVNPGTDLTVVDASGKQPIVLLQGYQMQGSENTLYLAAGQRLALATLSEEGIKALTVNGEWQADEYGNQWRQASLQGALTDPALADRKPLWQYAEKLDDTYC	 Cell inner membrane {ECO:0000250}; Single
sp|P00956|SYI_ECOLI	CREYAATQVDGQRKDFIRLGVLGDWSHPYLTMDFKTEANIIRALGKIIGNGHLHKGAKPVHWCVDCRSALAEAEVEYYDKTSPSIDVAFQAVDQDALKAKFAVSNVNGPISLVIWTTTPWTLPANRAISIAPDFDYALVQIDGQAVILAKDLVESVMQRIGVTDYTILGTVKGAELELLRFTHPFMGFDVPAILGDHVTLDAGTGAVHTAPGHGPDDYVIGQKYGLETANPVGPDGTYLPGTYPTLDGVNVFKANDIVVALLQEKGALLHVEKMQHSYPC	 Cytoplasm
sp|P39366|SGCX_ECOLI	CLNYHGRGTLAGLITPPRLIRMLEQTALEHNIPVQREVAPGVITETGYIQVEQDGIPCASLSIPCRYTHSPAEVASLRDLTDC	
sp|P46850|RTCB_ECOLI	CHHNYVQKEQHFGEEIYVTRKGAVSARAGQYGIIPGSMGAKSFIVRGLGNEESFCSCSHGAGRVMSRTKAKKLFSVEDQIRATAHVEC	
sp|P76350|SHIA_ECOLI	CELLTMYIVTAFALNYSTQNMGLPRELFLNIGLLVGGLSCLTIPCFAWLADRFGRRRVYITGTLIGTLSAFPFFMALEAQSIFWIVFFSIMLANIAHDMVVC	 Cell inner membran
sp|P10408|SECA_ECOLI	CIAEMRTGEGKTLTATLPAYLNALTGKGVHVVTVNDYLAQRDAENNRPLFEFLGLTVGINLPGMPAPAKREAYAADITYGTNNEYGFDYLRDNMAFSPEERVQRKLHYALVDEVDSILIDEARTPLIISGPAEDSSEMYKRVNKIIPHLIRQEKEDSETFQGEGHFSVDEKSRQVNLTERGLVLIEELLVKEGIMDEGESLYSPANIMLMHHVTAALRAHALFTRDVDYIVKDGEVIIVDEHTGRTMQGRRWSDGLHQAVEAKEGVQIQNENQTLASITFQNYFRLYEKLAGMTGTADTEAFEFSSIYKLDTVVVPTNRPMIRKDLPDLVYMTEAEKIQAIIEDIKERTAKGQPVLVGTISIEKSELVSNELTKAGIKHNVLNAKFHANEAAIVAQAGYPAAVTIATNMAGRGTDIVLGGSWQAEVAALENPTAEQIEKIKADWQVRHDAVLEAGGLHIIGTERHESRRIDNQLRGRSGRQGDAGSSRFYLSMEDALMRIFASDRVSGMMRKLGMKPGEAIEHPWVTKAIANAQRKVESRNFDIRKQLLEYDDVANDQRRAIYSQRNELLDVSDVSETINSIREDVFKATIDAYIPPQSLEEMWDIPGLQERLKNDFDLDLPIAEWLDKEPELHEETLRERILAQSIEVYQRKEEVVGAEMMRHFEKGVMLQTLDSLWKEHLAAMDYLRQGIHLRGYAQKDPKQEYKRESFSMFAAMLESLKYEVISTLSKVQVRMPEEVEELEQQRRMEAERLAQMQQLSHQDDDSAAAAALAAQTGERKVGRNDPCPCGSGKKYKQC	 Cell inner membrane; Peripheral membran
sp|P0AC41|SDHA_ECOLI	CKTGPEAILELEHMGLPFSRLDDGRIYQRPFGGQSKNFGGEQAARTAAAADRTGHALLHTLYQQNLKNHTTIFSEWYALDLVKNQDGAVVGCTALCIETGEVVYFKARATVLATGGAGRIYQSTTNAHINTGDGVGMAIRAGVPVQDMEMWQFHPTGIAGAGVLVTEGC	 Cell inner membran
sp|P00959|SYM_ECOLI	CKSPDQYGDNCEVCGATYSPTELIEPKSVVSGATPVMRDSEHFFFDLPSFSEMLQAWTRSGALQEQVANKMQEWFESGLQQWDISRDAPYFGFEIPNAPGKYFYVWLDAPIGYMGSFKNLC	 Cytoplasm
sp|P13458|SBCC_ECOLI	CEQEARIKTLEAQRAQLQAGQPCPLCGSTSHPAVEAYQALEPGVNQSRLLALENEVKKLGEEGATLRGQLDAITKQLQRDENEAQSLRQDEQALTQQWQAVTASLNITLQPLDDIQPWLDAQDEHERQLRLLSQRHELQGQIAAHNQQIIQYQQQIEQRQQLLLTTLTGYALTLPQEDEEESWLATRQQEAQSWQQRQNELTALQNRIQQLTPILETLPQSDELPHC	
sp|P07395|SYFB_ECOLI	CAQHPNADKLRVTKVNVGGDRLLDIVCGAPNCRQGLRVAVATIGAVLPGDFKIKAAKLRGEPSEGMLC	 Cytoplasm
sp|P76055|TTCA_ECOLI	CLSGGKDSYTMLEILRNLQQSAPINFSLVAVNLDQKQPGFPEHVLPEYLEKLGVEYKIVEENTYGIVKEKIPEGKTTCSLCSRLRRGILYRTATELGATKIALGHHRDDILQTLFLNMFYGGKMKGMPPKLMSDDGKHIVIRPLAYC	 Cytoplasm {ECO:0000255|HAMAP-Rule:MF_01850
sp|P25534|UBIH_ECOLI	CGVDWQQEPYEQLAVIANVATSVAHEGRAFERFTQHGPLAMLPMSDGRCSLVWCHPLERREEVLSWSDEKFC	
sp|P0A9P4|TRXB_ECOLI	CDALIIATGASARYLGLPSEEAFKGRGVSACATCDGFFYRNQKVAVIGGGNTAVEEALYLSNIASEVHLIHRRDGFRAEKILIKRLMDKVENGNIILHTNRTLEEVTGDQMGVTGVRLRDTQNSDNIESLDVAGLFVAIGHSPNTAIFEGQLELENGYIKVQSGIHGNATQTSIPGVFAAGDVMDHIYRQAITSAGTGC	 Cytoplasm
sp|P04693|TYRB_ECOLI	CYRHAIAPLLFGADHPVLKQQRVATIQTLGGSGALKVGADFLKRYFPESGVWVSDPTWENHVAIFAGAGFEVSTYPWYDEATNGVRFNDLLATLKTLPARSIVLLHPCCHNPTGADLTNDQWDAVIEILKARELIPFLDIAYQGFGAGMEEDAYAIRAIASAGLPALVSNSFSKIFSLYGERVGGLSVMC	 Cytoplasm
sp|P33226|TORC_ECOLI	CHSMQPVYEEYKQSVHFQNASGVRAECHDCHIPPDIPGMVKRKLEASNDIYQTFIAHSIDTPEKFEAKRAELAEREWARMKENNSATC	CHNYDAMDHAKQHPEAARQMKVAAKDNQSCIDCHKGIAHQLPDMSSGFRKQFDELRASANDSGDTLYSIDIKPIYAAKGDKEASGSLLPASEVKVLKRDGDWLQIEITGWTESAGRQRVLTQFPGKRIFVASIRGDVQQQVKTLEKTTVADTNTEWSKLQATAWMKKGDMVNDIKPIWAYADSLYNGTC	 Cell inner membrane; Single-pass type I
sp|P39453|TORS_ECOLI	CGIDPAKLAEIFQPFVQVSGKRGGTGLGLTISSRLAQAMGGELSATSTPEVGSCFCLRLPLRVATAPVPKTVNQAVRLDGLRLLLIEDNPLTQRITIEMLKTSGAQIVAVGNAAQALETLQNSEPFAAALVDFDLPDIDGITLARQLAQQYPSLVLIGFSAHVIDETLRQRTSSLFRGIIPKPVPREVLGQLLAHYLQLQVNNDQSLDVSQLNEDAQLMGTEKIHEWLVLFTQHALPLLDEIDIARASQDSEKIKRAAHQLKSSC	 Cell inner membran
sp|P23003|TRMA_ECOLI	CETIFVDPPRSGLDSETEKMVQAYPRILYISCNPETLCKNLETLSQTHKVERLALFDQFPYTHHMEC	
sp|P00895|TRPE_ECOLI	CSLSVFDAFRLLQNLLNVPKEEREAMFFGGLFSYDLVAGFEDLPQLSAENNCPDFCFYLAETLMVIDHQKKSTRIQASLFAPNEEEKQRLTARLNELRQQLTEAAPPLPVVSVPHMRC	
sp|P06612|TOP1_ECOLI	CQMTPAKYDSTTLTVGAGDFRLKARGRILRFDGWTKVMPALRKGDEDRILPAVNKGDALTLVELTPAQHFTKPPARFSEASLVKELEKRGIGRPSTYASIISTIQDRGYVRVENRRFYAEKMGEIVTDRLEENFRELMNYDFTAQMENSLDQVANHEAEWKAVLDHFFSDFTQQLDKAEKDPEEGGMRPNQMVLTSIDCPTCGRKMGIRTASTGVFLGC	CGTAMDSYLIDPKRKLHVCGNNPTCDGYEIEEGEFRIKGYDGPIVEC	CGSEMHLKMGRFGKYMACTNEECKNTRKILRNGEVAPPKEDPVPLPELPC	
sp|P77627|YBER_ECOLI	CEWRDYLAELNEQGQAYAQFVASTAECCGEGGIKAWDYVRMGFLSRMGVLNNWLSEEESLWIQSRIHLRALRYYSNWRQYFAGYTFGRQYWQSPEDDHLPLLREFLARKEYDDSGNDMFYQLFASDDAYYPTLSWQPLAYYSAC	
sp|P37443|YCAI_ECOLI	CSLRAQYLASLQTTLQPYPWNAVILGLGMGERLSVPKEIKNIMRDTGTAHLMAISGLHIAFAALLAAGLIRSGQIFLPGRWIHWQIPLIGGICCAAFYAWLTGMQPPALRTMVALATWGMLKLSGRQWSGWDVWIC	 Cell membrane {ECO:0000305}; Multi-pas
sp|P62066|YCEQ_ECOLI	CGKTAQLSKKQTGYYSPEIFPSTGKDCNPQPANCLKDQYVLRHC	
sp|P36661|YCCE_ECOLI	CFMRLYNELRRKVNEEDTPCLECESLEKEFEEMQNDNDLSLFMRILRTNDTQIYSGVSGGITYTIQYVRDIDIVRVSLPGRASESITDFKGYYWYNFMEYIENINAC	
sp|P0A8L5|YCGN_ECOLI	CRQLNIKTCQCRNYERRFEFEPDC	
sp|P37052|YCHJ_ECOLI	CWQDADNIGFVSFVARFTEGGKTGAIIERSRFLKENGQWYYIDGTRPQFGRNDPCPCGSGKKFKKC	
sp|Q46819|YGFS_ECOLI	CPFGMITIQSLPGDTRQQIVKCDLCEQREEGPAC	
sp|P00957|SYA_ECOLI	CVRAGGKHNDLENVGYTARHHTFFEMLGNFSFGDYFKHDAIQFAWELLTSEKWFALPKERLWVTVYESDDEAYEIWEKEVGIPRERIIRIGDNKGAPYASDNFWQMGDTGPCGPCTEIFYDHGDHIWGGPPGSPEEDGDRYIEIWNIVFMQFNRQADGTMEPLPKPSVDTGMGLERIAAVLQHVNSNYDIDLFRTLIQAVAKVTGATDLSNKSLRVIADHIRSC	 Cytoplasm
sp|Q46800|XDHB_ECOLI	CNGATSADSATPTLIYDAKLEIHSPRGVRFVPINGFHTGPGKVSLEHDEILVAFHFPPQPKEHAGSAHFKYAMRDAMDISTIGCAAHCRLDNGNFSELRLAFGVAAPTPIRC	
sp|Q46801|XDHC_ECOLI	CLYLAAWAEGKEIRTLEGEAKGGKLSHVQQAYAKSGAVQCGFCTPGLIMATTAMLAKPREKPLTITEIRRGLAGNLC	
sp|P23849|TRKG_ECOLI	CIGGGAWYTTKKSGIQLRTRDGFIIIVMFWILFSVISAFPLWIDSELNLTFIDALFEGVSGITTTGATVIDDVSSLPRAYLYYRSQLNFIGGLGVIVLAVAVLPLLGIGGAKLYQSEMPGPFKDDKLTPRLADTSRTLWITYSLLGIACIVCYRLAGMPLFDAIC	 Cell inner membran
sp|P76035|YCIW_ECOLI	CARINGSPACFATCMDSSNEYKKISTLMRKGENEINQWADRHSVERATVQAIQWLTRAPDRFSAAQFSPLLEHEKSSTQIINLLVWSGLC	
sp|P77539|YDJL_ECOLI	CNAYKSIAQQSKFLPGQDVVVIGTGPLGLFSVQMARIMGAVNIVVVGLQEDVAVRFPVAKELGATAVVNGSTEDVVARCQQICGKDNLGLVIEC	
sp|P77493|YDJH_ECOLI	CEALSYVDYLFPNFAEAKLLTGKETLDEIADCFLACGVKTVVIKTGKDGC	
sp|P0AD05|YECA_ECOLI	CFGYMRGVALSDWSTLPDSLKPALEAIALHGTEENFERVEKMSPEAFEESVDAIRLAALDLHAYWMAHPQEKAVQQPIKAEEKPGRNDPCPCGSGKKFKQC	
sp|P76463|YFAQ_ECOLI	CRGNSPEEVYCCQAGESITRDTALVRSC	
sp|P0ADW6|YHCC_ECOLI	CPNRDGTIGRGGCTFCNVASFADEAQQHRSIAEQLAHQANLVNRAKRYLAYFQAYTSTFAEVQVLRSMYQQAVSQANIVGLC	
sp|P56256|YSAA_ECOLI	CPFGAMEVVSSRKKARAIKCDLCWHRETGPAC	
sp|P52133|YFJR_ECOLI	CRLRTAGSEMQMVPDVLIFAHRSGLAGLFPGLDRRLVNALLMCDESPCVIAPANPVPSPSGALSFWRLIQAITGRRRVTLIAEGRRC	
sp|P52138|YFJW_ECOLI	CSGVLFQYFTAAFTKGNCYECSMKLDYIKQFYFSLETAWYLISAVAVFIASVFIQHRIKAYLTLLAITWIVLTITDVALIHALDNIAMNNILLNILYNLFGAILLSLFMC	 Cell membrane {ECO:0000305}; Multi-pas
sp|P55138|YGCE_ECOLI	CFAGHDLMSQFAGNKEDIVGIGLGSIRCCRALLKADGTPAAPLISWQDARVTRPYEHTNPDVAYVTSFSGYLTHRLTGEFKDNIANYFGQWPVDYKSWAWSEDAAVMDKFNIPRHMLFDVQMPGTVLGHITPQAALATHFPAGLPVVC	
sp|Q46906|YGCP_ECOLI	CIHRLFIVDSISFHNIDKQVAQSNPDCIEILPGCMPKVLGWVTEKIRQPLIAGGLVC	
sp|P65807|YGEY_ECOLI	CDEKRVVHRIKEEMEKVGFDKVEIDPMGNVLGYIGHGPRLVAMDAHIDTVGIGNIKNWDFDPYEGMETDELIGGRGTSDQEGGMASMVYAGKIIKDLGLEDEYTLLVTGTVQEEDCDGLCWQYIIEQSGIRPEFVVSTEPTDC	CHGSAPERGDNAIFKMGPILGELQELSQRLGYDEFLGKGTLTVSEIFFTSPSRCAVADSCAVSIDRRLTWGETWEGALDEIRALPAVQKANAVVSMYNYDRPSWTGLVYPTEC	
sp|P0ADT5|YGIC_ECOLI	CLKVVEKVIASDELMTKFRIPKHTWSFVRQSWLTHQPSLYSRLDLAWDGTGEPKLLENNADTPTSLYEAAFFQWIWLEDQLNAGNLPEGSDQFNSLQEKLIDRFVELREQYGFQLLHLTCCRDTVEDRGTIQYLQDC	
sp|Q46867|YGIZ_ECOLI	CSIPSVSGEDRILQAMIAAFFLLTPLIILILRKLFMREMFEFWVYVFSLGICLVCGWWLFWGRFIFC	 Cell inner membrane; Multi-pass membran
sp|P11291|Y3808_ECOLI	CQPYLVQRLLAVDNDFAAILKGNGQYAAVDFAVDIAVAIPVVQAFFNGQPELISQAMKFTVVHCCILFLSDGGSIAAWGQGFKVC	
sp|P45848|YCIQ_ECOLI	CILLLIAGLFVSSLSYAENTEIPSYEEGISLFDVEATLQPDGVLDIKENIHFQARNQQIKHGFYRDLPRLWMQPDGDAALLNYHIVGVTRDGIPEPWHLDWHIGLMSIVVGDKQRFLPQGDYHYQIHYQVKNAFLREGDSDLLIWNVTGNHWPFEIYKTRFSLQFSNIAGNPFSEIDLFTGEEGDTYRNGRILEDGRIESRDPFYREDFTVLYRWPHALLSNASAPQTTNIFSHLLLPSTSSLLIWFPCLFLVCGWLYLWKRRPQFTPVDVIETDVIPPDYTPGMLRLDAKLVYDDKGFC	
sp|P76162|YDFU_ECOLI	CQWPNGDYHHTETVIHRYGTGAMVLCWHCDNQLRDQTSESLELLAQQNLTAWVIDVIRHAISGTQERELSLAELSWWAVC	
sp|P0AD03|YEBS_ECOLI	CVIGAPLILVTSIAYLWFGNRLGMNLRPVLLMLERLKEWVMLDIYLVGIGVASIKVQDYAHIQAGVGLFSFVALVILTTVTLSHLNVEELWERFYPQRPATRRDEKLRVCLGCHFTGYPDQRGRC	 Cell inner membran
sp|P77503|YCJS_ECOLI	CSPNRFHYEHTLMALEAGCHVMCEKPPAMTPEQAREMC	
sp|P77147|YDHT_ECOLI	CSQFARSDDHARIGCCEDNARIATAGYAAQIASMGYSVRIGSVGFNSHIGSSGERARVAVTGNSSRISSAGDSSRIANTGMRVRVC	
sp|P76097|YDCJ_ECOLI	CRQLLEEYEQQGGFNETQAQEFVQEALETFRWHQSATVDEETYRALHNEHRLIADVVCFPGCHINHLTPRTLDIDRVQSMMPEC	
sp|P76361|YEER_ECOLI	CLDGGDWYPFSEGRRFVSFHHVDELRICASCGLTEVHHAPENHKPDPEWYC	 Cell inner membrane; Multi-pass membran
sp|P30855|EVGS_ECOLI	CKELIKNMQGDLSLESHPGIGTTFTITIPVEISQQVATVEAKAEQPITLPEKLSILIADDHPTNRLLLKRQLNLLGYDVDEATDGVQALHKVSMQHYDLLITDVNMPNMDGFELTRKLREQNSSLPIWGLTANAQANEREKGLSCGMNLCLFKPLTLDVLKTHLSQLHQVAHIAPQYRHLDIEALKNNTANDLQLMQEILMTFQHETHKDLPAAFQALEAGDNRTFHQC	 Cell inner membrane {ECO:0000305}; Multi
sp|P0A953|FABB_ECOLI	CLATPFKIHGVNYSISSACATSAHCIGNAVEQIQLGKQDIVFAGGGEELC	 Cytoplasm
sp|P69922|FUCI_ECOLI	CEEKFSSQNVGLTITVTPCWCYGSETIDMDPTRPKAIWGFNGTERPGAVYLAAALAAHSQKGIPAFSIYGHDVQDADDTSIPADVEEKLLRFARAGLAVASMKGKSYLSLGGVSMGIAGSIVDHNFFESWLGMKVQAVDMTELRRRIDQKIYDEAELEMALAWADKNFRYGEDENNKQYQRNAEQSRAVLRESLLMAMC	CKQRDSEGNPTMKPHWEISQQEADACLAATEWCPAIHEYFRGGGYSSRFLTEGGVPFTMTRVNIIKGLGPVLQIAEGWSVELPKDVHDILNKRTNSTWPTTWFAPRLTGKGPFTDVYSVMANWGANHGVLTIGHVGADFITLASMLRIPVC	 Cytoplasm
sp|P0A6T3|GAL1_ECOLI	CAPRDDRKVRVMAADYENQLDEFSLDAPIVAHENYQWANYVRGVVKHLQLRNNSFGGVDMVISGNVPQGAGLSSSASLEVAVGTVLQQLYHLPLDGAQIALNGQEAENQFVGCNCGIMDQLISALGKKDHALLIDC	 Cytoplasm {ECO:0000255|HAMAP-Rule:MF_00246}
sp|P25748|GALS_ECOLI	CNALIVHSKALSDDELAQFMDNIPGMVLINRVVPGYAHRCVCLDNLSGARMATRMLLNNGHQRIGYLSSSHGIEDDAMRKAGWMSALKEQDIIPPESWIGAGTPDMPGGEAAMVELLGRNLQLTAVFAYNDNMAAGALTALKDNGIAIPLHLSIIGFDDIPIARYTDPQLTTVRYPIASMAKLATELALQGAAGNIDPRASHC	
sp|P25437|FRMA_ECOLI	CSTFSEYTVVAEVSLAKINPEANHEHVCLLGCGVTTGIGAVHNTAKVQPGDSVAVFGLGAIGLAVVQGARQAKAGRIIAIDTNPKKFDLARRFGATDC	 Cytoplasm
sp|P33650|FEOB_ECOLI	CPVIPLVSTRGRGIEALKLAIDRYKANENVELVHYAQPLLNEADSLAKVMPSDIPLKQRRWLGLQMLEGDIYSRAYAGEASQHLDAALARLRNEMDDPALHIADARYQCIAAICDVVSNTLTAEPSRFTTAVDKIVLNRFLGLPIFLFVMYLMFLLAINIGGALQPLFDVGSVALFVHGIQWIGYTLHFPDWLTIFLAQGLGGGINTVLPLVPQIGMMYLFLSFLEDSGYMARAAFVMDRLMQALGLPGKSFVPLIVGFGC	 Cell inner membran
sp|P45759|GSPE_ECOLI	CQTMTSLSQADFEARLEAVFHQNTGESQQIAQDIDQSVDLLSLSEEMPANEDLLNEDSAAPVIRLINAILSEAIKETASDIHIETYEKTMSIRFRIDGVLRTILQPNKKLAALLISRIKVMARLDIAEKRIPQDGRISLRIGRRNIDVRVSTLPSIYGERAVLRLLDKNSLQLSLNNLGMTAADKQDLENLIQLPHGIILVTGPTGSGKSTTLYAILSALNTPGRNILTVEDPVEYELEGIGQTQVNTRVDMSFARGLRAILRQDPDVVMVGEIRDTETAQIAVQASLTGHLVLSTLHTNSASGAVTRLRDMGVESFLLSSSLAGIIAQRLVRRLCPQCRQFTPVSPQQAQMFKYHQLAVTTIGTPVGC	 Cytoplasm {ECO:0000305}
sp|P0CF10|INSA4_ECOLI	CSATDGVVRNGKSTAGHQRYLCSHCRKTWQLQFTYTASQPGTHQKIIDMAMNGVGC	
sp|P46846|GNTX_ECOLI	CRMPLALGHWGICSVCSRATRTDKTLC	
sp|P19767|INSA7_ECOLI	CSATEGVVRNGKSTAGHQRYLCSPCRKTWQLQFTYTASQPGKHQKIIDMAMNGVGC	
sp|P76102|INSQ_ECOLI	CIANIRRDYLHKVTTAVSKNHAMIVIEDLKVSNMSKSAAGTVSQPGRNVRAKSGLNRSILDQGWYEMRRQLAYKQLWRGGQVLAVPPAYTSQRCAYCGHTAKENRLSQSKFRC	
sp|P0CF08|INSA2_ECOLI	CSATDGVVRNGKSTAGHQRYLCSHCRKTWQLQFTYTASQPGTHQKIIDMAMNGVGC	
sp|P0CF09|INSA3_ECOLI	CSATDGVVRNGKSTAGHQRYLCSHCRKTWQLQFTYTASQPGTHQKIIDMAMNGVGC	
sp|P0CF12|INSA6_ECOLI	CSATDGVVRNGKSTAGHQRYLCSHCRKTWQLQFTYTASQPGTHQKIIDMAMNGVGC	
sp|P28630|HOLA_ECOLI	CQTPEQAQLPRWVAARAKQLNLELDDAANQVLCYCYEGNLLALAQALERLSLLWPDGKLTLPRVEQAVNDAAHFTPFHWVDALLMGKSKRALHILQQLRLEGSEPVILLRTLQRELLLLVNLKRQSAHTPLRALFDKHRVWQNRRGMMGEALNRLSQTQLRQAVQLLTRTELTLKQDYGQSVWAELEGLSLLLC	
sp|P23331|KITH_ECOLI	CYGLRTDFRGELFIGSQYLLAWSDKLVELKTICFCGRKASMVLRLDQAGRPYNEGEQVVIGGNERYVSVC	 Cytoplasm {ECO:0000255|HAMAP-Rule:MF_00124}
sp|P0ACV6|MPAA_ECOLI	CALRTLTPSLRRHHVVLCVNPDGCQLGLRANANGVDLNRNFPAANWKEGETVYRWNSAAEERDVVLLTGDKPGSEPETQALC	
sp|P0A7B3|NADK_ECOLI	CTKGYEVIVEQQIAHELQLKNVKTGTLAEIGQLADLAVVVGGDGNMLGAARTLARYDIKVIGINRGNLGFLTDLDPDNAQQQLADVLEGHYISEKRFLLEAQVCQQDCQKRISTAINEVVLHPGKVAHMIEFEVYIDEIFAFSQRSDGLIISTPTGSTAYSLSAGGPILTPSLDAITLVPMFPHTLSARPLVINSSSTIRLRFSHRRNDLEISC	 Cytoplasm {ECO:0000255|HAMAP-Rule:MF_00361}
sp|P39370|NANS_ECOLI	CPHDVQDMQGYHHPLATNHQTQYGTVGQALHIARKLLPFIPDNAGILIVPCCRGGSAFTAGSEGTYSERHGASHDAC	 Periplasm {ECO:0000305|PubMed:19749043}
sp|P19319|NARZ_ECOLI	CPVVSVYDLVLANYGLDRGLEDENSAKDYAEIKPYTPAWGEQITGVPRQYIETIAREFADTAHKTHGRSMIILGAGVNHWYHMDMNYRGMINMLIFCGCVGQSGGGWAHYVGQEKLRPQTGWLPLAFALDWNRPPRQMNSTSFFYNHSSQWRYEKVSAQELLSPLADASKYSGHLIDFNVRAERMGWLPSAPQLGRNPLGIKAEADKAGLSPTEFTAQALKSGDLRMAC	 Cell membrane; Peripheral membrane protein
sp|P11349|NARH_ECOLI	CPYKKIYFNWKSGKSEKCIFCYPRIEAGQPTVC	 Cell membrane; Peripheral membrane protein
sp|P0A746|MSRB_ECOLI	CGWPSFYEPVSEESIRYIKDLSHGMQRIEIRCGNCDAHLGHVFPDGPQPTGERYC	
sp|P0ABL3|NAPB_ECOLI	CQWTAMLALVVSGAVWAANGVDFSQSPEVSGTQEGAIRMPKEQDRMPLNYVNQPPMIPHSVEGYQVTTNTNRCLQCHGVESYRTTGAPRISPTHFMDSDGKVGAEVAPRRYFC	 Periplasm {ECO:0000269|PubMed:10234835
sp|P09152|NARG_ECOLI	CATSYDDVKAYTPAWAEQITGVSRSQIIRIAREFADNADKTHGRSMIIVGAGLNHWYHLDMNYRGLINMLIFCGCVGQSGGGWAHYVGQEKLRPQTGWQPLAFALDWQRPARHMNSTSYFYNHSSQWRYETVTAEELLSPMADKSRYTGHLIDFNVRAERMGWLPSAPQLGTNPLTIAGEAEKAGMNPVDYTVKSLKEGSIRFAAEQPENGKNHPRNLFIWRSNLLGSSGKGHEFMLKYLLGTEHGIQGKDLGQQGGVKPEEVDWQDNGLEGKLDLVVTLDFRLSSTC	 Cell membrane; Peripheral membrane protein
sp|P33934|NAPH_ECOLI	CQFFVLGMFLSGPWFGVWILHGNYSSSLLFDTVPLTDPLMTLQSLASGHLPATVALTGAVIITVLYALAGKRLFCSWVCPLNPITDLANWLRRRFDLNQSATIPRHIRYVLLVVILVGSALTGTLIWEWINPVSLMGRSLVMGFGSGALLILALFLFDLLVVEHGWC	 Cell inner membran
sp|P30870|GLNE_ECOLI	CNVSDEAGLMRELRLFRRRIMVRIAWAQTLALVTEESILQQLSYLAETLIVAARDWLYDACCREWGTPC	
sp|P10423|IAP_ECOLI	CFILPVHASSPKPGDFANTQARHIATFFPGRMTGTPAEMLSADYIRQQFQQMGYRSDIRTFNSRYIYTARDNRKSWHNVTGSTVIAAHEGKAPQQIIIMAHLDTYAPLSDADADANLGGLTLQGMDDNAAGLGVMLELAERLKNTPTEYGIRFVATSGEEEGKLGAENLLKRMSDTEKKNTLLVINLDNLIVGDKLYFNSGVKTPEAVRKLTRDRALAIARSHGIAATTNPGLNKNYPKGTGCCNDAEIFDKAGIAVLSVEATNWNLGNKDGYQQRAKTPAFPAGNSWHDVRLDNHQHIDKALPGRIERRC	
sp|P77454|GLSA1_ECOLI	CTLALALEDVGPQAVQDKIGADPTGLPFNSVIALELHGGKPLSPLVNAGAIATTSLINAENVEQRWQRILHIQQQLAGEQVALSDEVNQSEQTTNFHNRAIAWLLYSAGYLYCDAMEACDVYTRQC	
sp|P77364|GLXK2_ECOLI	CDPRLANCHIEVACDVDNPLVGARGAAAVFGPQKGATPEMVEELEQGLQNYARVLQQQTEINVC	
sp|P0AAN3|HYPB_ECOLI	CPASFDLGEKHKVAVLSVTEGEDKPLKYPHMFAAASLMLLNKVDLLPYLNFDVEKCIACAREVNPEIEIILISATSGEGMDQWLNWLETQRC	
sp|P24192|HYPD_ECOLI	CGGHTHAIFKFGLDQLLPENVEFIHGPGCPVCVLPMGRIDTC	
sp|P27249|GLND_ECOLI	CVDVWPRLPSTELIFIAALFHDIAKGRGGDHSILGAQDVVHFAELHGLNSRETQLVAWLVRQHLLMSVTAQRRDIQDPEVIKQFAEEVQTENRLRYLVCLTVADICATNETLWNSWKQSLLRELYFATEKQLRRGMQNTPDMRERVRHHQLQALALLRMDNIDEEALHQIWSRC	
sp|P0A9C0|GLPA_ECOLI	CTTADLALPGSQEPAEVTLRKVISLPAPLRGSAVYRHGDRTPAWLSEGRLHRSLVCECEAVTAGEVQYAVENLNVNSLLDLRRRTRVGMGTC	 Cell inner membrane; Peripheral membran
sp|P0A996|GLPC_ECOLI	CFVNYNHPQLGKDLIKVLNAMGTGVQLLSKEKCCGVPLIANGFTDKARKQAITNVESIREAVGVKGIPVIATSSTC	CHMEKMGWTLYTLELLRNIPGLELTVLDSQCCGIAGTYGFKKENYPTSQAIGAPLFRQIEESGADLVVTDC	 Cell inner membrane; Peripheral membran
sp|P0A6V8|GLK_ECOLI	CDIASGEISQAKTYSGLDYPSLEAVIRVYLEEHKVEVKDGCIAIACPITGDWVAMTNHTWAFSIAEMKKNLGFSHLEIINDFTAVSMAIPMLKKEHLIQFGGAEPVEGKPIAVYGAGTGLGVAHLVHVDKRWVSLPGEGGHVDFAPNSEEEAIILEILRAEIGHVSAERVLSGPGLVNLYRAIVKADNRLPENLKPKDITERALADSC	 Cytoplasm
sp|P30131|HYPF_ECOLI	CPPLARIDSVEREPFIWSQLPTEFTIRQSTGGTMNTQIVPDAATCPACLAEMNTPGERRYRYPFINC	CGPRFTIIRAMPYDRPFTVMAAFPLCPACDKEYRDPLDRRFHAQPVAC	
sp|P24193|HYPE_ECOLI	CAVLTPLIQTLRDIPGVKALRDATRGGVNAVVHEFAAACGCGIELSEAALPVKPAVRGVC	
sp|P0A6V1|GLGC_ECOLI	CINSGIRRMGVITQYQSHTLVQHIQRGWSFFNEEMNEFVDLLPAQQRMKGENWYRGTADAVTQNLDIIRRYKAEYVVILAGDHIYKQDYSRMLIDHVEKGARCTVACMPVPIEEASAFGVMAVDENDKIIEFVEKPANPPSMPNDPSKSLASMGIYVFDADYLYELLEEDDRDENSSHDFGKDLIPKITEAGLAYAHPFPLSC	
sp|P16431|HYCE_ECOLI	CWITVRVEVDANKPEYPSVTPRVPAAVWGEREVRDMYGLIPVGLPDERRLVLPDDWPDELYPLRKDSMDYRQRPAPTTDAETYEFINELGDKKNNVVPIGPLHVTSDEPGHFRLFVDGENIIDADYRLFYVHRGMEKLAETRMGYNEVTFLSDRVCGICGFAHSTAYTTSVENAMGIQVPERAQMIRAILLEVERLHSHLLNLGLAC	
sp|P77858|HYFC_ECOLI	CDGYLVIFALAQAVILLMLTPLFTGISRQIRARMHSRRGPGIWQDYRDIHKLFKRQEVAPTSSGLMFRLMPWVLISSMLVLAMALPLFITVSPFAGGGDLITLIYLLALFRFFFALSGLDTGSPFAGVGASRELTLGILVEPMLILSLLVLALIAGSTHIEMISNTLAMGWNSPLTTVLALLACGFACFIEMGKIPFDVAEAEQELQEGPLTEYSGAGLALAKWGLGLKQVVMASLFVALFLPFGRAQELSLAC	 Cell inner membran
sp|P77329|HYFG_ECOLI	CWIVVKALVDADSREFPSVTPRVPAAVWGEREIRDMYGLIPVGLPDQRRLVLPDDWPEDMHPLRKDAMDYRLRPEPTTDSETYPFINEGNSDARVIPVGPLHITSDEPGHFRLFVDGEQIVDADYRLFYVHRGMEKLAETRMGYNEVTFLSDRVCGICGFAHSVAYTNSVENALGIEVPQRAHTIRSILLEVERLHSHLLNLGLSC	
sp|P0A725|LPXC_ECOLI	CAKKFVRIKETVRVEDGDKWAEFKPYNGFSLDFTIDFNHPAIDSSNQRYAMNFSADAFMRQISRARTFGFMRDIEYLQSRGLCLGGSFDCAIVVDDYRVLNEDGLRFEDEFVRHKMLDAIGDLFMC	
sp|P0A6A6|LEUC_ECOLI	CTNSRIEDLRAAAEIAKGRKVAPGVQALVVPGSGPVKAQAEAEGLDKIFIEAGFEWRLPGCSMCLAMNNDRLNPGERC	
sp|P39285|MSCM_ECOLI	CATFARPNGLFIAHFGWPRERVSRGMRYYLMSIGLIVPLIMALMMFDNLDDREFSGSLGRLCFILICGALAVVTLSLKKAGIPLYLNKEGSGDNITNHMLWNMMIGAPLVAILASAVGYLATAQALLARLETSVAIWFLLLVVYHVIRRWMLIQRRRLAFDRAKHRRAEMLAQRARGEEEAHHHSSPEGAIEVDESEVDLDAISAQSLRLVRSILMLIALLSVIVLWSEIHSAFGFLENISLWDVTSTVQGVESLEPITLGAVLIAILVFIITTQLVRNLPALLELAILQHLDLTPGTGYAITTITKYLLMLIGGLVGFSMIGIEWSKLQWLVAALGVGLGFGLQEIFANFISGLIILFEKPIRIGDTVTIRDLTGSVTKINTRATTISDWDRKEIIVPNKAFITEQFINWSLSDSVTRVVLTIPAPADANSEEVTEILLTAARRC	 Cell inner membran
sp|P30745|MOAA_ECOLI	CHPDYAGEIGLIMPYEKDFCATCNRLRVSSIGKLHLC	
sp|P41036|NANT_ECOLI	CAAIFISFMVQSAGKRWPTGVMLMVVVLFAFLYSWPIQALLPTYLKTDLAYNPHTVANVLFFSGFGAAVGCCVGGFLGDWLGTRKAYVC	 Cell inner membrane {ECO:0000255|HAMAP
sp|P0ABK9|NRFA_ECOLI	CKSPDVARLIQKDGEDGYFHGKWARGGPEIVNNLGCADCHNTASPEFAKGKPELTLSRPYAARAMEAIGKPFEKAGRFDQQSMVC	CHVEYYFDGKNKAVKFPWDDGMKVENMEQYYDKIAFSDWTNSLSKTPMLKAQHPEYETWTAGIHGKNNVTCIDCHMPKVQNAEGKLYTDHKIGNPFDNFAQTC	 Periplasm {ECO:0000269|PubMed:11863430
sp|P0ABL1|NRFB_ECOLI	CHKPDTEGMHGKHASVINPNNKLPVTCTNCHGQPSPQHREGVKDVMRFNEPMYKVGEQNSVC	CHLPEQLQKAFWPHDVHVTKVACASCHSLHPQQDTMQTLSDKGRIKIC	 Periplasm {ECO:0000305}
sp|P0AAK7|NRFC_ECOLI	CPYRVRFIHPVTKTADKCDFCRKTNLQAGKLPAC	
sp|P19318|NARY_ECOLI	CPYKKIYFNWKSGKSEKCIFCYPRIESGQPTVC	 Cell membrane; Peripheral membrane protein
sp|P0ABL5|NAPC_ECOLI	CHEMRNTVYQEYMDSVHYNNRSGVRATCPDCHVPHEFVPKMIRKLKASKELYGKIFGVIDTPQKFEAHRLTMAQNEWRRMKDNNSQEC	 Cell inner membrane; Single-pass membran
sp|P76135|YDEO_ECOLI	CTNIQTVTVPVPAKFLRASNVPTGLLNEMIAYLNSEERNHHNFSELLLFSCLSIFAACKGFITLLTNGVLSVSGKVRNIVNMKPAHPWKLKDIC	
sp|P76186|YDHK_ECOLI	CLALTVAYYLNLDEPYWAMTSAAVVSFPTVGGVISKSLGRIAGSLLGAIAALLLAGHTLNEPWFFLLSMSAWLGFCTWACAHFTNNVAYAFQLAGYTAAIIAFPMVNITEASQLWDIAQARVC	 Cell membrane {ECO:0000305}; Multi-pas
sp|P32137|YIHP_ECOLI	CYSGVKERYVETQPANPAQKPGLLQSFRAIAGNRPLFILCIANLCTLGAFNVKLAIQVYYTQYVLNDPILLSYMGFFSMGC	 Cell inner membrane; Multi-pass membran
sp|P39389|YJIR_ECOLI	CWIREYFPCEICITRPKGGFLLWIELPEQVDMVC	
sp|P39314|YTFF_ECOLI	CLASAIQRTGAPVSTMIIGTLPVVIPVFANLLYSQRDGKLAWGKLAPALICIGIGLACVNIAELNHGLPDFDWARYTSGIVLALVSVVC	 Cell inner membrane; Multi-pass membran
sp|P0AE45|YTFL_ECOLI	CLIAVSAFFSMSEISLAASRKIKLKLLADEGNINAQRVLNMQENPGMFFTVVQIGLNAVAILGGIVGDAAFSPAFHSLFSRYMSAELSEQLSFILSFSLVTGMFILFADLTPKRIGMIAPEAVALRIINPMRFCLYVCTPLVWFFNGLANIIFRIFKLPMVRKDDITSDDIYAVVEAGALAGVLRKQEHELIENVFELESRTVPSSMTPRENVIWFDLHEDEQSLKNKVAEHPHSKFLVC	 Cell inner membrane; Multi-pass membran
sp|P76134|YDEM_ECOLI	CAFLKEHEFLVGISIDGPQELHDRYRRSNSGNGTFAKVIAAIERLKSYQVEFNTLTVINNVNVHYPLEVYHFLKSIGSKHMQFIELLETGTPNIDFSGHSENTFRIIDFSVPPTAYGKFMSTIFMQWVKNDVGEIFIRQFESFVSRFLGNGHTSCIFQESCKDNLVVESNGDIYEC	
sp|Q46904|YGCN_ECOLI	CIPGATVDALYEENGRVCGVICGDDILRARYVVLAEGANSVLAERHGLVTRPAGEAMALGIKEVLSLETSAIEERFHLENNEGAALLFSGRIC	
sp|P45537|YHFK_ECOLI	CLPVAVGLMLGELRFGLLFSLVPACCNIAGLDTPHKRFFKRLIIGASLFATC	 Cell membrane {ECO:0000305}; Multi-pas
sp|P37629|YHIL_ECOLI	CNYDSERQVLTSHHGIIRDEEKKCYCLGALQVPFNQMKNPTDPEELANIFNKKHKEHMDDPLFHLIRSNTLKPTPVYANYFDNTTDFRPARERIFIC	
sp|P68661|YBCO_ECOLI	CGTGTKPPDLIATIACSACHDEIDRRTHFVDAGYAKEC	
sp|P63340|YQEG_ECOLI	CLLSIPPSYIEAAKEEGVTILSALSMLPNAPAWLSISGIIVAVVAMSKSFLGTYFGVIEGATEVVKTTLQQVGVKKSRAFNRALSIMLVSLITFIVCCINPNAISMIYAISGPLIAMILFIMPTLSTYLIPALKPWRSIGNLITLIVGILC	 Cell inner membrane; Multi-pass membran
sp|P43319|YRAK_ECOLI	CGADSTSGATNYSSVVDDVTVNQTDNVTGREFTSATLSSTNWQYACSCSAGKAVKLVYMVSPVLTTTGHQTGYYKLNDSLDIKTTLQANDIPGLTTDQVVSVNTRFTQIKNNTVYSAATQTGVC	 Fimbrium {ECO:0000305}
sp|P75982|YMFQ_ECOLI	CIPAGTQTLRQRQQRLDAKVNLAGGINEDFYLAQLAALGRPDATITRYDKSTFTCSSACTDAVNAPEWRYYWQVNMPATTNSTWMTC	
sp|P64588|YQJI_ECOLI	CKHEGQPRHEGCCKGEKSEHEHC	
sp|P76228|YNJI_ECOLI	CANHSSGKSSAKLIWAAELSWMISISSTAFQNGTIEEELAWHYIMLASRKAHELFESEEDYQKNSQMGFLYWHICCYRRKLTDAELEAC	 Cell inner membrane; Multi-pass membran
sp|P0AAJ1|YNFG_ECOLI	CPYGAPQYNAEKGHMTKCDGCYSRVAEGKQPIC	
sp|P0ABF6|CDD_ECOLI	CARTPLSNFNVGAIARGVSGTWYFGANMEFIGATMQQTVHAEQSAISHAWLSGEKALAAITVNYTPCGHCRQFMNELNSGLDLRIHLPGREAHALRDYLPDAFGPKDLEIKTLLMDEQDHGYALTGDALSQAAIAAANRSHMPYSKSPSGVALEC	
sp|P00864|CAPP_ECOLI	CLKQLDNKDIADYEHNQLMRRLRQLIAQSWHTDEIRKLRPSPVDEAKWGFAVVENSLWQGVPNYLRELNEQLEENLGYKLPVEFVPVRFTSWMGGDRDGNPNVTADITRHVLLLSRWKATDLFLKDIQVLVSELSMVEATPELLALVGEEGAAEPYRYLMKNLRSRLMATQAWLEARLKGEELPKPEGLLTQNEELWEPLYACYQSLQACGMGIIANGDLLDTLRRVKC	
sp|P0AD14|BTSS_ECOLI	CMISTIVEGLLGGLVHSILIRRGRTDKVFNPITAGAVTFVAEMVQMLIILAIARPYEDAVRLVSNIAAPMMVTNTVGAALFMRILLDKRAMFEKYTSAFSATALKVAASTEGILRQGFNEVNSMKVAQVLYQELDIGAVAITDREKLLAFTGIGDDHHLPGKPISSTYTLKAIETGEVVYADGNEVPYRCSLHPQCKLGSTLVIPLRGENQRVMGTIKLYEAKNRLFSSINRTLGEGIAQLLSAQILAGQYERQKAMLTQSEIKLLHAQVNPHFLFNALNTIKAVIRRDSEQASQLVQYLSTFFRKNLKRPSEFVTLADEIEHVNAYLQIEKARFQSRLQVNIAIPQELSQQQLPAFTLQPIVENAIKHGTSQLLDTGRVAISARREGQHLMLEIEDNAGLYQPVTNASGLGMNLVDKRLRERFGDDYGISVAC	 Cell inner membran
sp|P0ABR7|CNTA_ECOLI	CPEVHDLKLAARFTTRTPANWKNIVDNYLECYHCGPAHPGFSDSVQVDRYWHTMHGNWTLQYGFAKPSEQSFKFEEGTDAAFHGFWLWPC	
sp|P06609|BTUC_ECOLI	CSALMTWAIYFSTSVDLRQLMYWMMGGFGGVDWRQSWLMLALIPVLLWICCQSRPMNMLALGEISARQLGLPLWFWRNVLVAATGWMVGVSVALAGAIGFIGLVIPHILRLC	 Cell inner membrane; Multi-pass membran
sp|P77744|ABGR_ECOLI	CRPGHPAIGARSIKQLLDYSWTMPTPHGSYYKQLSELLDDQAQTPQVGVVCETFSACISLVAKSDFLSKLPEEMGC	
sp|P23872|AES_ECOLI	CTVIGIDYTLSPEARFPQAIEEIVAACCYFHQQAEDYQINMSRIGFAGDSAGAMLALASALWLRDKQIDC	 Cytoplasm {ECO:0000269|PubMed:9576853}
sp|P31441|ADEC_ECOLI	CAEQARQNQYLQVSSCVPALEGCDVNGASFTLEQMLAWRDHPQVTGLAEMMDYPGVISGQNALLDKLDAFRHLTLDGHC	CHESYQLEEGRRKLQLGMSLMIREGSAARNLNALAPLINEFNSPQCMLCTDDRNPWEIAHEGHIDALIRRLIEQHNVPLHVAYRVASWSTARHFGLNHLGLLAPGKQADIVLLSDARKVTVQQVLVKGEPIDAQTLQAEESARLAQSAPPYGNTIARQPVSASDFALQFTPGKRYRVIDVIHNELITHSHSSVYSENGFDRDDVSFIAVLERYGQRLAPAC	
sp|P76518|ACOCT_ECOLI	CGGVYLFSGIVSALYGREKSQRGAHVDIAMFDATLSFLEHGLMAYIATGKSPQRLGNRHPYMAPFDVFNTQDKPITICCGNDKLFSALC	
sp|P37685|ALDB_ECOLI	CVVLKPARLTPLSVLLLMEIVGDLLPPGVVNVVNGAGGVIGEYLATSKRIAKVAFTGSTEVGQQIMQYATQNIIPVTLELGGKSPNIFFADVMDEEDAFFDKALEGFALFAFNQGEVCTCPSRALVQESIYERFMERAIRRVESIRSGNPLDSVTQMGAQVSHGQLETILNYIDIGKKEGADVLTGGRRKLLEGELKDGYYLEPTILFGQNNMRVFQEEIFGPVLAVTTFKTMEEALELANDTQYGLGAGVWSRNGNLAYKMGRGIQAGRVWTNC	
sp|P76217|ASTD_ECOLI	CRAARAAFPRWARLSFAERHAVVERFAALLESNKAELTAIIARETGKPRWEAATEVTAMINKIAISIKAYHVRTGEQRSEMPDGAASLRHRPHGVLAVFGPYNFPGHLPNGHIVPALLAGNTIIFKPSELTPWSGEAVMRLWQQAGLPPGVLNLVQGGRETGQALSALEDLDGLLFTGSANTGYQLHRQLSGQPEKILALEMGGNNPLIIDEVADIDAAVHLTIQSAFVTAGQRCTCARRLLLKSGAQGDAFLARLVAVSQRLTPGNWDDEPQPFIGGLISEQAAQQVVTAWQQLEAMGGRPLLAPRLLQAGTSLLTPGIIEMTGVAGVPDEEVFGPLLRVWRYDTFDEAIRMANNTRFGLSC	
sp|P75952|COMR_ECOLI	CFTSKDTPAGCFMINNCTTLSPDSGDIANTLKSRHAMQERTLQQFLC	
sp|P00509|AAT_ECOLI	CTQELLFGKGSALINDKRARTAQTPGGTGALRVAADFLAKNTSVKRVWVSNPSWPNHKSVFNSAGLEVREYAYYDAENHTLDFDALINSLNEAQAGDVVLFHGCCHNPTGIDPTLEQWQTLAQLSVEKGWLPLFDFAYQGFARGLEEDAEGLRAFAAMHKELIVASSYSKNFGLYNERVGAC	 Cytoplasm
sp|P77674|ABDH_ECOLI	CVVLKPSEITPLTALKLAELAKDIFPAGVINILFGRGKTVGDPLTGHPKVRMVSLTGSIATGEHIISHTASSIKRTHMELGGKAPVIVFDDADIEAVVEGVRTFGYYNAGQDCTAACRIYAQKGIYDTLVEKLGAAVATLKSGAPDDESTELGPLSSLAHLERVGKAVEEAKATGHIKVITGGEKRKGNGYYYAPTLLAGALQDDAIVQKEVFGPVVSVTPFDNEEQVVNWANDSQYGLASSVWTKDVGRAHRVSARLQYGC	
sp|P31552|CAIC_ECOLI	CESSGGVVNRYSYLELNQEINRTANLFYTLGIRKGDKVALHLDNCPEFIFCWFGLAKIGAIMVPINARLLC	CALRDDDVYLTVMPAFHIDCQCTAAMAAFSAGATFVLVEKYSARAFWGQVQKYRATVTEC	
sp|P60584|CAIA_ECOLI	CFITSSAYTPYIVVMARDGASPDKPVYTEWFVDMSKPGIKVTKLEKLGLRMDSCCEITFDDVELDEKDMFGREGNGFNRVKEEFDHERFLVALTNYGTAMC	 Cytoplasm {ECO:0000255|HAMAP-Rule:MF_01052
sp|Q59385|COPA_ECOLI	CVKRVKESLEQRPDVEQADVSITEAHVTGTASAEQLIETIKQAGYDASVSHPKAKPLAESSIPSEALTAVSEALPAATADDDDSQQLLLSGMSCASCVTRVQNALQSVPGVTQARVNLAERTALVMGSASPQDLVQAVEKAGYGAEAIEDDAKRRERQQETAVATMKRFRWQAIVALAVGIPVMVWGMIGDNMMVTADNRSLWLVIGLITLAVMVFAGGHFYRSAWKSLLNGAATMDTLVALGTGVAWLYSMSVNLWPQWFPMEARHLYYEASAMIIGLINLGHMLEARARQRSSKALEKLLDLTPPTARLVTDEGEKSVPLAEVQPGMLLRLTTGDRVPVDGEITQGEAWLDEAMLTGEPIPQQKGEGDSVHAGTVVQDGSVLFRASAVGSHTTLSRIIRMVRQAQSSKPEIGQLADKISAVFVPVVVVIALVSAAIWYFFGPAPQIVYTLVIATTVLIIAC	 Copper-exporting P-type ATPase: Cell inne
sp|P0AB74|KBAY_ECOLI	CSAYSTTYNMPLALHLDHHESLDDIRRKVHAGVRSAMIDGSHFPFAENVKLVKSVVDFCHSQDCSVEAELGRLGGVEDDMSVDAESAFLTDPQEAKRFVELTGVDSLAVAIGTAHGLYSKTPKIDFQRLAEIREVVDVPLVLHGASDVPDEFVRRTIELGVTKVNVATELKIAFAGAVKAWFAENPQGNDPRYYMRVGMDAMKEVVRNKINVC	
sp|P21865|KDPD_ECOLI	CIGHNTGSEKLVRAAARLASRLGSVWHAVYVETPALHRLPEKKRRAILSALRLAQELGAETATLSDPAEEKAVVRYAREHNLGKIILGRPASRRWWRRETFADRLARIAPDLDQVLVALDEPPARTINNAPDNRSFKDKWRVQIQGCVVAAALCAVITLIAMQWLMAFDAANLVMLYLLGVVVVALFYGRWPSVVATVINVVSFDLFFIAPRGTLAVSDVQYLLTFAVMLTVGLVIGNLTAGVRYQARVARYREQRTRHLYEMSKALAVGRSPQDIAATSEQFIASTFHARSQVLLPDDNGKLQPLTHPQGMTPWDDAIAQWSFDKGLPAGAGTDTLPGVPYQILPLKSGEKTYGLVVVEPGNLRQLMIPEQQRLLETFTLLVANALERLTLTASEEQARMASEREQIRNALLAALSHDLRTPLTVLFGQAEILTLDLASEGSPHARQASEIRQHVLNTTRLVNNLLDMARIQSGGFNLKKEWLTLEEVVGSALQMLEPGLSSPINLSLPEPLTLIHVDGPLFERVLINLLENAVKYAGAQAEIGIDAHVEGENLQLDVWDNGPGLPPGQEQTIFDKFARGNKESAVPGVGLGLAIC	 Cell inner membran
sp|P0C8K0|KBAZ_ECOLI	CQLADSLNFPQDALILGGDHLGPNRWQNLPAAQAMANADDLIKSYVAAGFKKIHLDCSMSCQDDPIPLTDDIVAERAARLAKVAEETC	
sp|P0AAJ8|HYBA_ECOLI	CPYNVPKYDYNNPFGALHKCELCNQKGVERLDKGGLPGC	 Periplasm
sp|P0AAK4|HYDN_ECOLI	CPYGAMEVVVRPVIRNSGAGLNVRADKAEANKCDLCNHREDGPAC	
sp|P23482|HYFB_ECOLI	CSLYSLTYMREYEGKGAAAMGFFMNIFIASMVALLVMDNAFWFIVLFEMMSLSSWFLVIARQDKTSINAGMLYFFIAHAGSVLIMIAFLLMGRESGSLDFASFRTLSLSPGLASAVFLLAFFGFGAKAGMMPLHSWLPRAHPAAPSHASALMSGVMVKIGIFGILKVAMDLLAQTGLPLWWGILVMAIGAISALLGVLYALAEQDIKRLLAWSTVENVGIILLAVGVAMVGLSLHDPLLTVVGLLGALFHLLNHALFKGLLFLGAGAIISRLHTHDMEKMGALAKRMPWTAAACLIGCLAISAIPPLNGFISEWYTWQSLFSLSRVEAVALQLAGPIAMVMLAVTGGLAVMC	 Cell inner membran
sp|P30147|HYI_ECOLI	CLVGKTPAGFSSEQIHATLVENLRYAANMLMKEDILLLIEPINHFDIPGFHLTGTRQALKLIDDVGCCNLKIQYDIYHMQRMEGELTNTMTQWADKIGHLQIADNPHRGEPGTGEINYDYLFKVIENSDYNGWVGC	
sp|P52074|GLCF_ECOLI	CAQPTLSPNTNAATARVLDRLGISVMPANEAGCCGAVDYHLNAQEKGLARARNNIDAWWPAIEAGAEAILQTASGC	CTLQHAQKLNGEVEKVLLRLGFTLTDVPDSHLCCGSAGTYALTHPDLARQLRDNKMNALESGKPEMIVTANIGC	
sp|P15067|GLGX_ECOLI	CPVLSQVKLIAEPWDIAPGGYQVGNFPPLFAEWNDHFRDAARRFWLHYDLPLGAFAGRFAASSDVFKRNGRLPSAAINLVTAHDGFTLRDCVCFNHKHNEANGEENRDGTNNNYSNNHGKEGLGGSLDLVERRRDSIHALLTTLLLSQGTPMLLAGDEHGHSQHGNNNAYC	
sp|P62620|ISPG_ECOLI	CARDKNIPIRIGVNAGSLEKDLQEKYGEPTPQALLESAMRHVDHLDRLNFDQFKVSVKASDVFLAVESYRLLAKQIDQPLHLGITEAGGARSGAVKSAIGLGLLLSEGIGDTLRVSLAADPVEEIKVGFDILKSLRIRSRGINFIACPTCSRQEFDVIGTVNALEQRLEDIITPMDVSIIGC	
sp|P36645|HOFB_ECOLI	CETLVRLQQMGVARWMLSSALTLVIAQRLVRKLCPHCRRQQGEPIHIPDNVWPSPLPHWQAPGC	
sp|P62615|ISPE_ECOLI	CGLSMDELAEMGLTLGADVPVFVRGHAAFAEGVGEILTPVDPPEKWYLVAHPGVSIPTPVIFKDPELPRNTPKRSIETLLKCEFSNDCEVIARKRFREVDAVLSWLLEYAPSRLTGTGAC	
sp|P75858|ELFG_ECOLI	CHTTQGNPYIGVNFGVKTLEEEANTAGVVKDKFYQWNESNDYYVSCDCDKDNVRSGRWAFAADSPLVYLGDNWYKINDYLAAKVLLQVKGSSPTAVPFENVGTGGDTRWHIC	 Fimbrium {ECO:0000305}
sp|P0A9B6|E4PD_ECOLI	CTGVYGSREHGEAHIAAGAKKVLFSHPGSNDLDATVVYGVNQDQLRAEHRIVSNASCTTNCIIPVIKLLDDAYGIESGTVTTIHSAMHDQQVIDAYHPDLRRTRAASQSIIPVDTKLAAGITRFFPQFNDRFEAIAVRVPTINVTAIDLSVTVKKPVKANEVNLLLQKAAQGAFHGIVDYTELPLVSVDFNHDPHSAIVDGTQTRVSGAHLIKTLVWC	 Cytoplasm
sp|P24174|MANC_ECOLI	CRLNGVECESPVVICNEQHRFIVAEQLRQLNKLTENIILEPAGRNTAPAIALAALAAKRHSPESDPLMLVLAADHVIADEDAFRAAVRNAMPYAEAGKLVTFGIVPDLPETGYGYIRRGEVSAGEQDMVAFEVAQFVEKPNLETAQAYVASGEYYWNSGMFLFRAGRYLEELKKYRPDILDAC	
sp|P0ACD8|MBHL_ECOLI	CGTMFRGLEIILQGRDPRDAWAFVERICGVCTGVHALASVYAIEDAIGIKVPDNANIIRNIMLATLWC	 Cell membrane; Peripheral membrane protein
sp|P69741|MBHT_ECOLI	CAALAATMGLSSKAAAEMAESVTNPQRPPVIWIGAQECTGCTESLLRATHPTVENLVLETISLEYHEVLSAAFGHQVEENKHNALEKYKGQYVLVVDGSIPLKDNGIYC	CERRPHFDAGRFAKEFGDEGHREGWCLYHLGCKGPETYGNC	 Cell membrane; Peripheral membrane protein
sp|P37355|MENH_ECOLI	CHEWQEVGEAFADYSRLYVDLPGHGGSAAISVDGFDDVTDLLRKTLVSYNILDFWLVGYSLGGRVAMMAACQGLAGLCGVIVEGGHPGLQNAEQRAERQRSDRQWVQRFLTEPLTAVFADWYQQPVFASLNDDQRRELVALRSNNNGATLAAMLEATSLAVQPDLRANLSARTFAFYYLC	
sp|P25665|METE_ECOLI	CWSFPREDVSRETIAKQIALALRDEVADLEAAGIGIIQIDEPALREGLPLRRSDWDAYLQWGVEAFRINAAVAKDDTQIHTHMCYCEFNDIMDSIAALDADVITIETSRSDMELLESFEEFDYPNEIGPGVYDIHSPNVPSVEWIEALLKKAAKRIPAERLWVNPDC	
sp|P32715|MDTO_ECOLI	CWQSDWRISESEAMAARECNLENICQTLLQLGQMDPNTPPTPAAKPPSMAADAFTNPDYMRYAVKTLLAC	 Cell inner membran
sp|P07003|POXB_ECOLI	CHRNHVPVLAIAAHIPSSEIGSGYFQETHPQELFRECSHYCELVSSPEQIPQVLAIAMRKAVLNRGVSVVVLPGDVALKPAPEGATMHWYHAPQPVVTPEEEELRKLAQLLRYSSNIALMC	 Cell membrane; Peripheral membrane protein
sp|P0ADR8|PPNN_ECOLI	CWGGHSINENEYLYARRVGNQLGLRELNICTGCGPGAMEAPMKGAAVGHAQQRYKDSRFIGMTEPSIIAAEPPNPLVNELIIMPDIEKRLEAFVRIAHGIIIFPGGVGTAEELLYLLGILMNPANKDQVLPLILTGPKESADYFRVLDEFVVHTLGENARRHYRIIIDDAAEVARQMKKSMPLVKENRRDTGDAYSFNWSMRIAPDLQMPFEPSHENMANLKLYPDQPVEVLAADLRRAFSGIVAGNVKEVGIRAIEEFGPYKINGDKEIMRRMDDLLQGFVAQHRMKLPGSAYIPC	
sp|P17888|PRIA_ECOLI	CDHYYTLHQAQHHLRCHHCDSQRPVPRQC	
sp|P0AC26|NIRC_ECOLI	CAANAARIARLSANNPLGFWVSSAMAGAYVGLGIILIFTLGNLLDPSVRPLVMGATFGIALTLVIIAGSELFTGHTMFLTFGVKAGSISHGQMWAILPQTWLGNLVGSVFVAMLYSWGGGSLLPVDTSIVHSVALAKTTAPAMVLFFKGALCNWLVCLAIWMALRTEGAAKFIAIWWC	 Cell inner membran
sp|P0AFA7|NHAB_ECOLI	CVAAAFLSAFLDALTVVAVVISVAVGFYGIYHRVASSRTEDTDLQDDSHIDKHYKVVLEQFRGFLRSLMMHAGVGTALGGVMTMVGEPQNLIIAKAAGWHFGDFFLRMSPVTVPVLICGLLTCLLVEKLRWFGYGETLPEKVREVLQQFDDQSRHQRTRQDKIRLIVQAIIGVWLVTALALHLAEVGLIGLSVIILATSLTGVTDEHAIGKAFTESLPFTALLTVFFSVVAVIIDQQLFSPIIQFVLQASEHAQLSLFYIFNGLLSSISDNVFVGTIYINEAKAAMESGAITLKQYELLAVAINTGTNLPSVATPNGQAAFLFLLTSALAPLIRLSYGRMVWMALPYTLVLTLVGLLC	 Cell inner membran
sp|P56579|PTHC_ECOLI	CAGNPVSRYLLLPCIGTFVFCNPMTLSLGRFMPEKYKPSYYAAASYSC	 Cell inner membrane {ECO:0000255|PROSITE
sp|P15640|PUR2_ECOLI	CRFGDPETQPIMLRMKSDLVELCLAACESKLDEKTSEWDERASLGVVMAAGGYPGDYRTGDVIHGLPLEEVAGGKVFHAGTKLADDEQVVTNGGRVLC	
sp|Q46877|NORV_ECOLI	CREHGREIARQWALAPLPQSTVNTVVKEETSATTTADLGPRMQCSVCQWIYDPAKGEPMQDVAPGTPWSEVPDNFLC	 Cytoplasm
sp|P62517|OPGH_ECOLI	CRRWGSQYSYMVVLDADSVMTGDCLCGLVRLMEANPNAGIIQSSPKASGMDTLYARC	 Cell inner membrane; Multi-pass membran
sp|P37013|NORR_ECOLI	CLRVDVRVLAATNRDLREEVLAGRFRADLFHRLSVFPLSVPPLRERGDDVILLAGYFCEQCRLRQGLSRVVLSAGARNLLQHYSFPGNVRELEHAIHRAVVLARATRSGDEVILEAQHFAFPEVTLPTPEVAAVPVVKQNLREATEAFQRETIRQALAQNHHNWAAC	
sp|P0A9G2|NHAR_ECOLI	CPIDSTQQEGLFSVRIGECGVSFWCTNPPPEKPFPAC	 Cytoplasm
sp|Q46836|PPPA_ECOLI	CQAKISKRYPLVELLTALAFLLASLVWPESGWGLAVMILSAWLIAASVIDLDHQWLPDVFTQGVLWTGLIAAWAQQSPLTLQDAVTGVLVGFITFYSLRWIAGIVLRKEALGMGDVLLFAALGGWVGALSLPNVALIASCCGLIYAVITKRGSTTLPFGPC	 Cell inner membrane; Multi-pass membran
sp|P76440|PRET_ECOLI	CNNEVGNTLTLEQLKAENRAVLVTVGLSSGSGLPLFEHSDVEIAVDFLQRARQAQGDISIPQSALIIGGGDVAMDVASTLKVLGCQAVTCVAREELDEFPASEKEFTSARELGVSIIDGFTPVAVEGNKVTFKHVRLSGELTMAADKIILAVGQHARLDAFAELEPQRNTIKTQNYQTRDPQVFAAGDIVEGDKTVVYAVKTGKEAAEAIHHYLEGAC	
sp|P08201|NIRB_ECOLI	CASWNNRVFGLVAPGYKMAQVAVDHILGSENAFEGADLSAKLKLLGVDVGGIGDAHGRTPGARSYVYLDESKEIYKRLIVSEDNKTLLGAVLVGDTSDYGNLLQLVLNAIELPENPDSLILPAHSGSGKPSIGVDKLPDSAQICSCFDVTKGDLIAAINKGC	CEHFAYSRQELFHLIRVEGIKTFEELLAKHGKGYGCEVCKPTVGSLLASC	
sp|P0AFL9|PQIA_ECOLI	CEHHHAAKHILCSQCDMLVALPRLEHGQKAAC	CLITILLLVNRAELPVRLKEQLARVLFQLKTWGMAEIFLAGVLVSFVKLMAYGSIGVGSSFLPWCLFCVLQLRAFQC	 Cell inner membran
sp|P07001|PNTA_ECOLI	CKEKDGNITVDFDDVVIRGVTVIRAGEITWPAPPIQVSAQPQAAQKAAPEVKTEEKCTCSPWRKYALMALAIILFGWMASVAPKEFLGHFTVFALAC	 Cell inner membrane; Multi-pass membran
sp|P30136|THIC_ECOLI	CLSHHQENFLYQHFREICEICAAYDVSLSLGDGLRPGSIQDANDEAQFAELHTLGELTKIAWEYDVQVMIEGPGHVPMQMIRRNMTEELEHC	
sp|P21888|SYC_ECOLI	CHIGHGRTFVAFDVVARYLRFLGYKLKYVRNITDIDDKIIKRANENGESFVAMVDRMIAEMHKDFDALNILRPDMEPRATHHIAEIIELTEQLIAKGHAYVADNGDVMFDVPTDPTYGVLSRQDLDQLQAGARVDVVDDKRNPMDFVLWKMSKEGEPSWPSPWGAGRPGWHIECSAMNCKQLGNHFDIHGGGSDLMFPHHENEIAQSTC	 Cytoplasm
sp|P0AG24|SPOT_ECOLI	CVGARVDRQPYPLSQPLTSGQTVEIITAPGARPNAAWLNFVVSSKARAKIRQLLKNLKRDDSVSLGRRLLNHALGGSRKLNEIPQENIQRELDRMKLATLDDLLAEIGLGNAMSVVVAKNLQHGDASIPPATQSHGHLPIKGADGVLITFAKCCRPIPGDPIIAHVSPGKGLVIHHESC	 Cytoplasm {ECO:0000269|PubMed:17616600}
sp|P32138|SQASE_ECOLI	CKENAGGDYYWTFFPQPTFVSTQKYYCHVDNSCYMNFDFSAPEYHELALWEDKATLRFEC	
sp|P0AGL7|RSME_ECOLI	CGVKLDSERLNKKLQQWQKIAIAACEQCGRNRVPEIRPAMDLEAWC	 Cytoplasm {ECO:0000305}
sp|P31549|THIP_ECOLI	CFASFATVLSLGGGPQATTIELAIYQALSYDYDPARAAMLALLQMVCCLGLVLLSQRLSKAIAPGTTLLQGWRDPDDRLHSRIC	 Cell inner membran
sp|P42632|TDCE_ECOLI	CRKSGVLTGLPDGYGRGRIIGDYRRVALYGISYLVRERELQFADLQSRLEKGEDLEATIRLREELAEHRHALLQIQEMAAKYGFDISRPAQNAQEAVQWLYFAYLAAVKSQNGGAMSLGRTASFLDIYIERDFKAGVLNEQQAQELIDHFIMKIRMVRFLRTPEFDSLFSGDPIWATEVIGGMGLDGRTLVTKNSFRYLHTLHTMGPAPEPNLTILWSEELPIAFKKYAAQVSIVTSSLQYENDDLMRTDFNSDDYAIACCVSPMVIGKQMQFFGARANLAKTLLYAINGGVDEKLKIQVGPKTAPLMDDVLDYDKVMDSLDHFMDWLAVQYISALNIIHYMHDKYSYEASLMALHDRDVYRTMAC	 Cytoplasm {ECO:0000250}
sp|P28916|YBFD_ECOLI	CAVISGAEGWEDIEDFGETHPDFLKQYGDFENGIPVHDTIARVVSCICPAKFHESFINWMLDYHSSDDKDVIAIDGKIHRHSYDKSRRKGAIHVISAFSTMHSLVIGQIKTDKKSNEITAIPELLNMLDIKGKIIKTDAMGC	
sp|Q46820|YGFT_ECOLI	CPFGVVEMVDTIAQKCDLCNQRSSGTQAC	
sp|P52037|YGFF_ECOLI	CTVENLTAERINRVLSTNVTGYFLCCREAVKRMALKNGGSGGAIVNVSSVASRLGSPGEYVDYAASKGAIDTLTTGLSLEVAAQGIRVNC	
sp|Q46811|YGFK_ECOLI	CATPVGPAAGPHTQLAQNIVTSWLTGGRFIELKTVQILDRLELEKPCIDAEDECFNTEWSTEFTLLKAWDEYLKAWFALHLLEAMFQPSDSGKSFIFNMSVGYNLEGIKQPPMQQFIDNMMDASDHPKFAQYRDTLNKLLQDDAFLARHGLQEKRESLQALPARIPTSMVHGVTLSTMHGC	
sp|P45563|XAPA_ECOLI	CMKGRGHFYEGRGMTIMTDAIRTFKLLGCELLFCTNAAGSLRPEVGAGSLVALKDHINTMPGTPMVGLNDDRFGERFFSLANAYDAEYRALLQKVAKEEGFPLTEGVFVSYPGPNFETAAEIRMMQIIGGDVVGMSVVPEVISARHC	
sp|P76090|YNBA_ECOLI	CNQQTRLGAILNETGDVISDIALYLPFLFLPESNASLVILMLFCTILTEFCGLLAQTINGVRSYAGPFGKSDRALIFGLWGLAVAIYPQWMQWNNLLWSIASILLLWTAINRC	 Cell inner membrane; Multi-pass membran
sp|P45771|YRDD_ECOLI	CGAELVIRSGKHGPFLGCSQYPACDYVRPLKSSADGHIVKVLEGQVC	CGANLVLRQGRFGMFIGCINYPECEHTELIDKPDETAITC	CQFAINFKPIAGECPECHYPLLIEKKTAQGVKHFC	
sp|P76117|YNCG_ECOLI	CQVPTLALENDEIMTETAAIALMVLDRRPDLAPPVGRAERQLFQRLLVWLVANVYPTFTFADYPERWAPDAPEQLKKNVIEYRKSLYIWLNSQLTAEPYAFGEQLTLVDCYLCTMRTWGPGHEWFQDNATNISAIADAVC	
sp|P77375|YDHX_ECOLI	CPYQVRYLNPVTKVADKCDFCAESRLAKGFPPIC	
sp|P0A9E9|YEIL_ECOLI	CFIGEIELIDKDHEPRAVQAIEECWCLALPMKHYRPLLLNDTLFLRKLC	 Cytoplasm {ECO:0000305|PubMed:11101674}
sp|P52124|YFJI_ECOLI	CGHWRSVGIMSDEAGIIFNGYTLNELPFINKMWDGSIFTVERKNEPEKLIRDARITLSLMVQPNVFKGYIDRKGDMAKGIGFFARCLMCQPASTQGNRKISNPIFSNEHLPVFHQRLMEIVNESIIKINENNRIC	
sp|Q46908|YGCR_ECOLI	CFTQVERFTLDALFITLEQRTEHGLRCCRVRLPAVIAVRQC	
sp|P42626|YHAM_ECOLI	CAATTAAMGAAAGMAWLVDGRYETISMAISSMIGDVSGMICDGASNSCAMKVSTSASAAWKAVLMALDDTAVTGNEGIVAHDVEQSIANLC	
sp|P0ACU7|YJDC_ECOLI	CVKNNRYPGCLFIAACTFYPDPGHPIHQLADQQKSAAYDFTHELLTTLEVDDPAMVAKQMELVLEGC	
sp|Q47319|YFIP_ECOLI	CLLPEKLCLCSTITPAQAKSRFC	
sp|P37630|YHIM_ECOLI	CLIAVPVLLTLLGFIWSITLLRSADITPHYVAGHVLLGLTAICACLIGLVATIVHQTRNTFSTKEHWLWC	CSLANRIPMIPVFTCLFCLFLASFLAEMAQTDMGYFIPSRVLVGLGAVC	 Cell inner membrane; Multi-pass membran
sp|P31447|YIDJ_ECOLI	CYSGKPLNTQNIDSLAAEGIRFNSAYTCSPVCTPARAGLFTGIYANQSGPWTNNVAPGKNISTMGRYFKDAGYHTC	
sp|P0AF59|YJDI_ECOLI	CYTGEKIDVYFNTAICQHSGNCVRGNGKLFNLKRKPWIMPDEVDVATVVKVIDTC	
sp|Q46814|XDHD_ECOLI	CPDIYYTPGGQSAPEPSPLDRRMFGKKMRHVGDRVAAVVAESEEIALEALKLIDVEYEVLKPVMSIDEAMAEDAPVVHDEPVVYVAGAPDTLEDDNSHAAQRGEHMIINFPIGSRPRKNIAASIHGHIGDMDKGFADADVIIERTYNSTQAQQCPTETHICFTRMDGDRLVIHASTQVPWHLRRQVARLVGMKQHKVHVIKERVGGGFGSKQDILLEEVC	
sp|P71237|WCAC_ECOLI	CEKVKNHKPDVTLVWTLHDHWSVTGRCAFTDGCEGWKTGC	
sp|P37669|WECH_ECOLI	CLIFYSAIALLYIALFTSINMELALKNLLQKPVFYHLWFFFAIAVIYLVSPLIQVKNVGGKMLLVLMAVIGIIANPNTVPQKIDGFEWLPINLYINGDTFYYILYGMLGRAIGMMDTQHKALSWVSAALFATGVFIISRGTLYELQWRGNFADTWYLYCGPMVFICAIALLTLVKNTLDTRTIRGLGLISRHSLGIYGFHALIIHALRTRGIELKNWPILDIIWIFC	 Cell inner membrane {ECO:0000255|HAMAP
sp|P0ACR2|YDHB_ECOLI	CVVASHHPLALMDGPFSDDTLRNWPSLVREDTSRTLPKRITWLLDNQKRVVVPDWESSATCISAGLCIGMVPTHFAKPWLNEGKWVALELENPFPDSAC	
sp|P32136|YIHO_ECOLI	CAIFRNPPLLVLCIANLCTLAAFNIKLAIQVYYTQYVLNDINLLSWMGFFSMGC	 Cell inner membrane {ECO:0000305}; Multi
sp|P0AAL9|YKGJ_ECOLI	CIALAGTPGKNACCTIYKNRSSTC	
sp|P76100|YDCK_ECOLI	CRIFGHALIDQHSMIVAAQGLTPDHQLLLQIYDRARVSASRIVHQAQIYGDAVVRYAFIEHRAEVFDFASIEGNEENNVWLCDCAKVYGHAQVKAGIEEDAIPTIHYSSQVAEYAIVEGNC	
sp|P77748|YDIJ_ECOLI	CPPEGLDAPMMKVDAVKRGTFDRQIPIAVRQQWRGAMECNGNGLCFNFDARSPMC	CTEVTALPGAPAQWAAIFARFGAKLENVSVGCCGMAGTYGHEAKNHENSLGIYELSWHQAMQRLPRNRC	
sp|Q46911|YGCU_ECOLI	CQRVDSKLIETWFNNLNWGPDKVAAERVQILKTGNMGFTTEVSGCWSCIHEIYESVINRIRTEFPHADDITMLGGHSSHSYQNGTNMYFVYDYNVVDC	
sp|P27837|YIFK_ECOLI	CIVVASYQGVELIGITAGEAKNPQVTLRSAVGKVLWRILIFYVGAIFVIVTIFPWNEIGSNGSPFVLTFAKIGITAAAGIINFVVLTAALSGCNSGMYSCGRMLYALAKNRQLPAAMAKVSRHGVPVAGVAVSIAILLIGSC	 Cell inner membrane; Multi-pass membran
sp|P39384|YJIM_ECOLI	CVAETGDVYDALADKYLAIGCSCVSPNDQRLKMLSQMVEEYQVDGVVDVILQAC	
sp|P37342|YJJI_ECOLI	CDMFEGHAPYKPRYVLPDYARFLANGSEWLELEGAKDLDDALSLLTILYHHVPSVTSMPVYLGQLDALLQPYVRILTQDEIDVRIKRFWRYLDRTLPDAFMHANIGPSDSPITRAILRADAELKQVSPNLTFIYDPEITPDDLLLEVAKNICECSKPHIANGPVHDKIFTKGGYGIVSC	
sp|P39391|YJIT_ECOLI	CNRDFAACFVLFCSEWYRRDYERQC	
sp|P39407|YJJU_ECOLI	CNQPGYARKVIMRYTTKREFFDPLRFVRGGNLIDLDWLVEATASQMPLQMDTAARLFDSGKSFYMCACRQDDYAPNYFLPTKQNWLDVIRASSAIPGFYRSGVSLEGINYLDGGISDAIPVKEAARQGAKTLVVIRTVPSQMYYTPQWFKRMERWLGDSSLQPLVNLVQHHETSYRDIQQFIEKPPGKLRIFEIYPPKPLHSIALGSRIPALREDYKLGRLC	
sp|P76507|YFDI_ECOLI	CKNNKSMLLLFFSLLIISTAKNQFILTPLIVYSYYIFFDRHKLIIKSVICVVCLLASIFAISYSKGVVELNKYHATYFGSYLYMKNNGYKMPSYVDDKC	 Cell membrane {ECO:0000305}; Multi-pas
sp|P37197|YHJA_ECOLI	CYLGLSGYVWYHDNKRSKQADVQASAVSENNKVLGFLREKGCDYCHTPSAELPAYYYIPGAKQLMDYDIKLGYKSFNLEAVRAALLADKPVSQSDLNKIEWVMQYETMPPTRYTALHWAGKVSDEERAEILAWIAKQRAEYYASNDTAPEHRNEPVQPIPQKLPTDAQKVALGFALYHDPRLSADSTISC	
sp|P77561|YDEP_ECOLI	CYKPLSWQQAFDEIGARLQSYSDPNQVEFYTSGRTSNEAAFLYQLFAREYGSNNFPDCSNMCHEPTSVGLAASIGVGKGTVLLEDFEKC	
sp|P76544|YFFM_ECOLI	CIAQKRVALREFSELVLGTLSLLLEQKTNGKCSASLYDCSEEEKLFVKRLKLIKADIHAQLKAC	
sp|P76257|YOAA_ECOLI	CVLRNLPQTNQPGSARQLAAMLRPIIEANNGRCFMLCTSHAMMRDLAEQFRATMTLPVLLQGETSKGQLLQQFVSAGNALLVATSSFWEGVDVRGDTLSLVIIDKLPFTSPDDPLLKARMEDC	
sp|P39352|YJHB_ECOLI	CASTYAVESWPKNLQSKASAFLVSGFSVGNIIAAQIIPQFAEVYGWRNSFFIGLLPVLLVLWIRKSAPESQEWIEDKYKDKSTFLSVFRKPHLSISMIVFLVCFCLFGANWPINGLLPSYLADNGVNTVVISTLMTIAGLGTLTGTIFFGFVGDKIGVKKAFVVGLITSFIFLC	 Cell inner membrane {ECO:0000305}; Multi
sp|P39367|YJHP_ECOLI	CTWARDHGITGTGIDMSSLFTAQAKRRAEELGVSERVHFIHNDAAGYVANEKCDVAACVGATWIAGGFAGAEELLAQSLKPGGIMLIGEPYWRQLPATEEIAQAC	 Membrane {ECO:0000305}; Single-pass membran
sp|P77252|YKGE_ECOLI	CRVNFPEKQGCCGQPAINSGYIKEAIPGMKNLIAALEDNDDPIISPAGSC	CSLARKLGVKDEPLTLLKNVRGLELLTFAEQDTCCGFGGTFSVKMAEISGEMVKEKVAHLMEVRPEYLIGADVSC	
sp|P76403|YEGQ_ECOLI	CLLSGYINKRDPNQGTCTNACRWEYNVQEGKEDDVGNIVHKYEPIPVQNVEPTLGIGAPTDKVFMIEEAQRPGEYMTAFEDEHGTYIMNSKDLRAIAHVERLTKMGVHSLKIEGRTKSFYYC	
sp|P33029|YEIQ_ECOLI	CDNIPDNGHVVKNAVLGMAEKRSPELAGWIKEHVSFPGTMVDRIVPAATDESLVEISQHLGVNDPCAISCEPFIQWVVEDNFVAGRPAWEVAGVQMVNDVLPWEEMKLRMLNGSHSFLAYLGYLSGFAHISDC	
sp|P11290|YIBD_ECOLI	CMESLITQTWTALEIIIINDGSTDNSVEIAKYYAENYPHVRLLHQANAGASVARNRGIEVATGKYVAFVDADDEVYPTMYETLMTMALEDDLDVAQCNADWCFRETGETWQSIPTDRLRSTGVLTGPDWLRMGLSSRRWTHVVWMGVYRRDVIVKNNIKFIAGLHHQDIVWTTEFMFNALRARYTEQSLYKYYLHNTSVSRLHRQGNKNLNYQRHYIKITRLLEKLNRNYADKIMIYPEFHQQITYEALRVC	
sp|P76093|YNBD_ECOLI	CSTTFEQRRLVHRLILATVMACCGFLLYPLKFSFIRPEVSGVTGWLFSQLELFDLPYNQSPSLHIILC	 Cell membrane {ECO:0000305}; Multi-pas
sp|P76575|YFGJ_ECOLI	CGEFIEMKALCPDCHQPLQVLKAC	
sp|P39277|YJEH_ECOLI	CTVVVLHFDAYGEKMAAAASLPKIVVQLFGVGALWIACVIGYLACFASLNIYIQSFARLVWSQAQHNPDHYLARLSSRHIPNNALNAVLGC	 Cell inner membran
sp|P37617|ZNTA_ECOLI	CSSTPTLSENVSGTRYSWKVSGMDCAACARKVENAVRQLAGVNQVQVLFATEKLVVDADNDIRAQVESALQKAGYSLRDEQAAEEPQASRLKENLPLITLIVMMAISWGLEQFNHPFGQLAFIATTLVGLYPIARQALRLIKSGSYFAIETLMSVAAIGALFIGATAEAAMVLLLFLIGERLEGWAASRARQGVSALMALKPETATRLRKGEREEVAINSLRPGDVIEVAAGGRLPADGKLLSPFASFDESALTGESIPVERATGDKVPAGATSVDRLVTLEVLSEPGASAIDRILKLIEEAEERRAPIERFIDRFSRIYTPAIMAVALLVTLVPPLLFAASWQEWIYKGLTLLLIGC	 Cell inner membran
sp|P06715|GSHR_ECOLI	CALIEAKELGGTCVNVGCVPKKVMWHAAQIREAIHMYGPDYGFDTTINKFNWETLIASRTAYIDRIHTSYENVLGKNNVDVIKGFARFVDAKTLEVNGETITADHILIATGGRPSHPDIPGVEYGIDSDGFFALPALPERVAVVGAGYIAVELAGVINGLGAKTHLFVRKHAPLRSFDPMISETLVEVMNAEGPQLHTNAIPKAVVKNTDGSLTLELEDGRSETVDC	 Cytoplasm
sp|P76641|GUAD_ECOLI	CENKDEIAWVKSLYPDHDGYLDVYHQYGLTGKNCVFAHCVHLEEKEWDRLSETKSSIAFC	
sp|P0AAJ5|FDOH_ECOLI	CPFDIPRLNPEDNRVYKCTLCVDRVVVGQEPAC	 Cell membrane; Single-pass membrane protein
sp|P39405|FHUF_ECOLI	CEDKNATPHSPQHRMETLISQALVPVVQALEATGEINGKLIWSNTGYLINWYLTEMKQLLGEATVESLRHALFFEKTLTNGEDNPLWRTVVLRDGLLVRRTCCQRYRLPDVQQC	 Cytoplasm. Cell membrane; Periphera
sp|P19323|FHLA_ECOLI	CEALSQLVKRSALADNAAIVLWQAQTQRASYYASREKDTPIKYEDETVLAHGPVRSILSRPDTLHCSYEEFCETWPQLDAGGLYPKFGHYC	
sp|P25526|GABD_ECOLI	CAKDIKKVSLELGGNAPFIVFDDADLDKAVEGALASKFRNAGQTCVCANRLYVQDGVYDRFAEKLQQAVSKLHIGDGLDNGVTIGPLIDEKAVAKVEEHIADALEKGARVVC	
sp|P04079|GUAA_ECOLI	CPFAIMANEEKRFYGVQFHPEVTHTRQGMRMLERFVRDICQCEALWTPAKIIDDAVARIREQVGDDKVILGLSGGVDSSVTAMLLHRAIGKNLTC	
sp|P11553|FUCK_ECOLI	CGATNVRAIAVNRQGKIVARASTPNASDIAMENNTWHQWSLDAILQRFADCCRQINSELTEC	
sp|Q47142|HCAT_ECOLI	CGVVRWGIMGATTALPWLIVVQILHCGTFTVCHLAAMRYIAARQGSEVIRLQAVYSAVAMGGSIAIMTVFAGFLYQYLGHGVFWVMALVALPAMFLRPKVVPSC	 Cell inner membrane {ECO:0000305}; Multi
sp|P0CF07|INSA1_ECOLI	CSATDGVVRNGKSTAGHQRYLCSHCRKTWQLQFTYTASQPGTHQKIIDMAMNGVGC	
sp|P0CF11|INSA5_ECOLI	CSATDGVVRNGKSTAGHQRYLCSHCRKTWQLQFTYTASQPGTHQKIIDMAMNGVGC	
sp|P75825|HCP_ECOLI	CEQTIRTPAGNGCSYAQGMCGKTAETSDLQDLLIAALQGLSAWAVKAREYGIINHDVDSFAPRAFFSTLTNVNFDSPRIVGYAREAIALREALKAQC	CDGARGERHYFTDFATSVPDDCLILTLACGKYRFNKLEFGDIEGLPRLVDAGQC	 Cytoplasm {ECO:0000255|HAMAP-Rule:MF_00069}
